Date,Date_1,Date_3,DAILY_CASES,CUMULATIVE_CASES,new_cases_smoothed,total_deaths,DAILY_CASES,CUMULATIVE_CASES,DAILY_RECOVERIES,RECOVERIES,Daily Deaths,Cumulative Deaths,ACTIVE CASES,ACTIVE CASES2,Case Fatality Rate,Daily Tests,Cumulative Tests
13/03/2020,2020-03-05,2020/03/13,1,1,,,0,0,0,0,0,0,0,0,"0,0%",0,0
14/03/2020,2020-03-06,2020/03/14,0,1,,,1,1,0,0,0,0,1,1,"0,0%",0,0
20/03/2020,2020-03-07,2020/03/15,0,1,,,0,1,0,0,0,0,1,1,"0,0%",0,0
22/03/2020,2020-03-08,2020/03/16,2,3,,,3,4,0,0,0,0,4,4,"0,0%",0,0
23/03/2020,2020-03-09,2020/03/17,0,3,,,1,5,0,0,0,0,5,5,"0,0%",0,0
25/03/2020,2020-03-10,2020/03/18,4,7,1,,1,6,0,0,0,0,6,6,"0,0%",0,0
26/03/2020,2020-03-11,2020/03/19,6,13,"1,857",,3,9,0,0,0,0,9,9,"0,0%",0,0
31/03/2020,2020-03-12,2020/03/20,4,17,"2,286",,0,9,0,0,0,0,9,9,"0,0%",0,0
06/04/2020,2020-03-13,2020/03/21,7,24,"3,286",,1,10,3,3,,0,7,7,"0,0%",0,0
08/04/2020,2020-03-14,2020/03/22,14,38,"5,286",,2,12,3,6,,0,6,6,"0,0%",0,0
11/04/2020,2020-03-15,2020/03/23,13,51,"6,857",,2,14,0,6,,0,8,8,"0,0%",0,0
13/04/2020,2020-03-16,2020/03/24,11,62,"8,429",,1,15,1,7,,0,8,8,"0,0%",0,0
14/04/2020,2020-03-17,2020/03/25,0,62,"7,857",,1,16,0,7,,0,9,9,"0,0%",0,0
15/04/2020,2020-03-18,2020/03/26,54,116,"14,714",,1,17,0,7,,0,10,10,"0,0%",0,0
17/04/2020,2020-03-19,2020/03/27,34,150,19,,2,19,0,7,,0,12,12,"0,0%",0,0
18/04/2020,2020-03-20,2020/03/28,52,202,"25,429",,3,22,0,7,,0,15,15,"0,0%",0,0
20/04/2020,2020-03-21,2020/03/29,38,240,"28,857",,2,24,0,7,,0,17,17,"0,0%",0,0
21/04/2020,2020-03-22,2020/03/30,34,274,"31,857",,7,31,0,7,,0,24,24,"0,0%",0,0
22/04/2020,2020-03-23,2020/03/31,128,402,"48,571",,1,32,2,9,,0,23,23,"0,0%",0,0
23/04/2020,2020-03-24,2020/04/01,152,554,"70,286",,4,36,0,9,,0,27,27,"0,0%",0,0
24/04/2020,2020-03-25,2020/04/02,155,709,"84,714",,4,40,0,9,,0,31,31,"0,0%",0,0
25/04/2020,2020-03-26,2020/04/03,218,927,111,,16,56,0,9,,0,47,47,"0,0%",0,0
26/04/2020,2020-03-27,2020/04/04,243,1170,"138,286",1,4,60,0,9,,0,51,51,"0,0%",0,0
27/04/2020,2020-03-28,2020/04/05,17,1187,"135,286",1,5,65,0,9,,0,56,56,"0,0%",0,0
28/04/2020,2020-03-29,2020/04/06,93,1280,"143,714",2,6,71,0,9,,0,62,62,"0,0%",0,0
29/04/2020,2020-03-30,2020/04/07,46,1326,132,3,20,91,0,9,,0,82,82,"0,0%",0,0
30/04/2020,2020-03-31,2020/04/08,27,1353,"114,143",5,9,100,0,9,,0,91,91,"0,0%",0,0
01/05/2020,2020-04-01,2020/04/09,27,1380,"95,857",5,6,106,2,11,,0,95,95,"0,0%",0,0
02/05/2020,2020-04-02,2020/04/10,82,1462,"76,429",5,2,108,0,11,,0,97,97,"0,0%",0,0
03/05/2020,2020-04-03,2020/04/11,43,1505,"47,857",9,5,113,0,11,,0,102,102,"0,0%",0,0
04/05/2020,2020-04-04,2020/04/12,80,1585,"56,857",9,3,116,0,11,,0,105,105,"0,0%",0,0
05/05/2020,2020-04-05,2020/04/13,70,1655,"53,571",11,3,119,0,11,,0,108,108,"0,0%",0,0
06/05/2020,2020-04-06,2020/04/14,31,1686,"51,429",12,4,123,0,11,,0,112,112,"0,0%",0,0
07/05/2020,2020-04-07,2020/04/15,63,1749,"56,571",13,30,153,2,13,,0,140,140,"0,0%",0,0
08/05/2020,2020-04-08,2020/04/16,96,1845,"66,429",18,6,159,0,13,,0,146,146,"0,0%",0,0
09/05/2020,2020-04-09,2020/04/17,89,1934,"67,429",18,4,163,0,13,,0,150,150,"0,0%",0,0
10/05/2020,2020-04-10,2020/04/18,69,2003,"71,143",24,9,172,13,26,,0,146,146,"0,0%",0,0
11/05/2020,2020-04-11,2020/04/19,25,2028,"63,286",25,3,175,1,27,,0,148,148,"0,0%",0,0
12/05/2020,2020-04-12,2020/04/20,145,2173,74,25,11,186,0,27,,0,159,159,"0,0%",0,0
13/05/2020,2020-04-13,2020/04/21,99,2272,"83,714",27,1,187,20,47,,0,140,140,"0,0%",0,0
14/05/2020,2020-04-14,2020/04/22,143,2415,"95,143",27,0,187,3,50,,0,137,137,"0,0%",0,0
15/05/2020,2020-04-15,2020/04/23,91,2506,"94,429",34,3,190,16,66,,0,124,124,"0,0%",0,0
16/05/2020,2020-04-16,2020/04/24,99,2605,"95,857",48,12,202,6,72,,0,130,130,"0,0%",0,0
17/05/2020,2020-04-17,2020/04/25,178,2783,"111,429",50,1,203,1,73,,0,130,130,"0,0%",0,0
18/05/2020,2020-04-18,2020/04/26,251,3034,"143,714",52,2,205,5,78,,0,127,127,"0,0%",0,0
19/05/2020,2020-04-19,2020/04/27,124,3158,"140,714",54,3,208,9,87,,0,121,121,"0,0%",0,0
20/05/2020,2020-04-20,2020/04/28,142,3300,"146,857",58,9,217,10,97,,0,120,120,"0,0%",0,0
21/05/2020,2020-04-21,2020/04/29,165,3465,150,58,3,220,15,112,,0,108,108,"0,0%",0,0
22/05/2020,2020-04-22,2020/04/30,170,3635,"161,286",65,5,225,7,119,,0,106,106,"0,0%",0,0
23/05/2020,2020-04-23,2020/05/01,318,3953,"192,571",75,13,238,0,119,,0,119,119,"0,0%",0,0
24/05/2020,2020-04-24,2020/05/02,267,4220,"205,286",79,12,250,37,156,,0,94,94,"0,0%",0,0
25/05/2020,2020-04-25,2020/05/03,141,4361,"189,571",86,6,256,2,158,,0,98,98,"0,0%",0,0
26/05/2020,2020-04-26,2020/05/04,185,4546,"198,286",87,6,262,6,164,,0,98,98,"0,0%",0,0
27/05/2020,2020-04-27,2020/05/05,247,4793,"213,286",90,11,273,4,168,,0,105,105,"0,0%",0,0
28/05/2020,2020-04-28,2020/05/06,203,4996,"218,714",93,7,280,0,168,,0,112,112,"0,0%",0,0
29/05/2020,2020-04-29,2020/05/07,354,5350,245,103,0,280,0,168,,0,112,112,"0,0%",0,0
30/05/2020,2020-04-30,2020/05/08,297,5647,242,103,4,284,0,168,,0,116,116,"0,0%",0,0
31/05/2020,2020-05-01,2020/05/09,304,5951,"247,286",116,2,286,21,189,,0,97,97,"0,0%",0,0
01/06/2020,2020-05-02,2020/05/10,385,6336,"282,143",123,9,295,5,194,,0,101,101,"0,0%",0,0
02/06/2020,2020-05-03,2020/05/11,447,6783,"319,571",131,1,296,4,198,,0,98,98,"0,0%",0,0
03/06/2020,2020-05-04,2020/05/12,437,7220,"346,714",138,1,297,3,201,,0,96,96,"0,0%",0,0
04/06/2020,2020-05-05,2020/05/13,352,7572,368,148,5,302,0,201,,0,101,101,"0,0%",0,0
05/06/2020,2020-05-06,2020/05/14,236,7808,"351,143",153,5,307,23,224,,0,83,83,"0,0%",0,0
06/06/2020,2020-05-07,2020/05/15,424,8232,"369,286",161,17,324,0,224,,0,100,100,"0,0%",0,0
07/06/2020,2020-05-08,2020/05/16,663,8895,"420,571",178,11,335,1,225,,0,110,110,"0,0%",0,0
08/06/2020,2020-05-09,2020/05/17,525,9420,"440,571",186,7,342,4,229,,0,113,113,"0,0%",0,0
09/06/2020,2020-05-10,2020/05/18,595,10015,"461,714",194,31,373,3,232,,0,141,141,"0,0%",0,0
10/06/2020,2020-05-11,2020/05/19,637,10652,"490,286",206,27,400,3,235,,0,165,165,"0,0%",0,0
11/06/2020,2020-05-12,2020/05/20,698,11350,"539,714",206,51,451,2,237,,0,214,214,"0,0%",0,0
12/06/2020,2020-05-13,2020/05/21,724,12074,"609,429",219,23,474,8,245,,0,229,229,"0,0%",0,0
13/06/2020,2020-05-14,2020/05/22,665,12739,"643,857",238,14,488,1,246,,0,242,242,"0,0%",0,0
14/06/2020,2020-05-15,2020/05/23,785,13524,"661,286",247,4,492,2,248,,0,244,244,"0,0%",0,0
15/06/2020,2020-05-16,2020/05/24,831,14355,705,261,16,508,1,249,,0,259,259,"0,0%",0,0
16/06/2020,2020-05-17,2020/05/25,1160,15515,"785,714",264,14,522,10,259,,0,263,263,"0,0%",0,0
17/06/2020,2020-05-18,2020/05/26,918,16433,"825,857",286,42,564,3,262,,0,302,302,"0,0%",232,232
18/06/2020,2020-05-19,2020/05/27,767,17200,"835,714",312,24,588,5,267,,0,321,321,"0,0%",315,547
19/06/2020,2020-05-20,2020/05/28,803,18003,847,339,37,625,9,276,,0,349,349,"0,0%",,547
20/06/2020,2020-05-21,2020/05/29,1134,19137,914,369,4,629,9,285,,0,344,344,"0,0%",,547
21/06/2020,2020-05-22,2020/05/30,988,20125,943,397,8,637,0,285,,0,352,352,"0,0%",142,689
22/06/2020,2020-05-23,2020/05/31,1218,21343,"998,286",407,8,645,6,291,,0,354,354,"0,0%",,689
23/06/2020,2020-05-24,2020/06/01,1240,22583,"1009,714",429,31,676,28,319,,0,357,357,"0,0%",,689
24/06/2020,2020-05-25,2020/06/02,1032,23615,1026,481,17,693,12,331,,0,362,362,"0,0%",,689
25/06/2020,2020-05-26,2020/06/03,649,24264,"1009,143",524,17,710,16,347,,0,363,363,"0,0%",223,912
26/06/2020,2020-05-27,2020/06/04,1673,25937,"1133,429",552,22,732,20,367,,0,365,365,"0,0%",320,1232
27/06/2020,2020-05-28,2020/06/05,1466,27403,"1180,857",577,17,749,3,370,,0,379,379,"0,0%",402,1634
28/06/2020,2020-05-29,2020/06/06,1837,29240,"1302,143",611,36,785,2,372,,0,413,413,"0,0%",376,2010
29/06/2020,2020-05-30,2020/06/07,1727,30967,"1374,857",643,14,799,8,380,,0,419,419,"0,0%",238,2248
30/06/2020,2020-05-31,2020/06/08,1716,32683,"1442,857",683,16,815,28,408,,0,407,407,"0,0%",,2248
01/07/2020,2020-06-01,2020/06/09,1674,34357,"1534,571",705,31,846,10,418,,0,428,428,"0,0%",,2248
02/07/2021,2020-06-02,2020/06/10,1455,35812,"1649,714",755,33,879,34,452,,0,427,427,"0,0%",407,2655
03/07/2020,2020-06-03,2020/06/11,1713,37525,"1655,429",792,37,916,63,515,,0,401,401,"0,0%",536,3191
04/07/2020,2020-06-04,2020/06/12,3267,40792,"1912,714",848,45,961,20,535,,0,426,426,"0,0%",,3191
05/07/2020,2020-06-05,2020/06/13,2642,43434,"2027,714",908,34,995,12,547,,0,448,448,"0,0%",,3191
06/07/2020,2020-06-06,2020/06/14,2539,45973,"2143,714",952,24,1019,17,564,,0,455,455,"0,0%",,3191
07/07/2020,2020-06-07,2020/06/15,2312,48285,"2228,857",998,45,1064,6,570,,0,494,494,"0,0%",428,3619
08/07/2020,2020-06-08,2020/06/16,2594,50879,"2360,286",1080,83,1147,18,588,,0,559,559,"0,0%",410,4029
09/07/2020,2020-06-09,2020/06/17,2112,52991,"2454,143",1162,78,1225,21,609,,0,616,616,"0,0%",457,4486
10/07/2020,2020-06-10,2020/06/18,2430,55421,"2556,571",1210,46,1271,24,633,,0,638,638,"0,0%",,4486
11/07/2020,2020-06-11,2020/06/19,3147,58568,"2539,429",1284,54,1325,23,656,,0,669,669,"0,0%",444,4930
12/07/2020,2020-06-12,2020/06/20,3359,61927,"2641,857",1354,42,1367,12,668,,0,699,699,"0,0%",377,5307
13/07/2020,2020-06-13,2020/06/21,3809,65736,"2823,286",1423,38,1405,20,688,,0,717,717,"0,0%",409,5716
14/07/2020,2020-06-14,2020/06/22,4302,70038,"3107,571",1480,46,1451,7,695,,0,756,756,"0,0%",453,6169
15/07/2020,2020-06-15,2020/06/23,3495,73533,"3236,286",1568,57,1508,29,724,,0,784,784,"0,0%",435,6604
16/07/2020,2020-06-16,2020/06/24,2801,76334,"3334,714",1625,63,1571,12,736,,0,835,835,"0,0%",529,7133
17/07/2020,2020-06-17,2020/06/25,4078,80412,"3570,143",1674,69,1640,33,769,,0,871,871,"0,0%",481,7614
18/07/2020,2020-06-18,2020/06/26,3478,83890,"3617,429",1737,111,1751,24,793,,0,958,958,"0,0%",441,8055
19/07/2020,2020-06-19,2020/06/27,3825,87715,3684,1831,64,1815,29,822,,0,993,993,"0,0%",477,8532
20/07/2020,2020-06-20,2020/06/28,4966,92681,"3849,286",1877,38,1853,28,850,,0,1003,1003,"0,0%",,8532
21/07/2020,2020-06-21,2020/06/29,4621,97302,"3894,857",1930,68,1921,5,855,,0,1066,1066,"0,0%",,8532
22/07/2020,2020-06-22,2020/06/30,4288,101590,"4008,143",1991,44,1965,21,876,,0,1089,1089,"0,0%",353,8885
23/07/2020,2020-06-23,2020/07/01,4518,106108,"4253,429",2102,85,2050,6,882,,0,1168,1168,"0,0%",375,9260
24/07/2020,2020-06-24,2020/07/02,5688,111796,"4483,429",2205,52,2102,47,929,,0,1173,1173,"0,0%",365,9625
25/07/2020,2020-06-25,2020/07/03,6579,118375,"4926,429",2292,69,2171,11,940,,0,1231,1231,"0,0%",352,9977
26/07/2020,2020-06-26,2020/07/04,6215,124590,"5267,857",2340,66,2237,46,986,,0,1251,1251,"0,0%",399,10376
27/07/2020,2020-06-27,2020/07/05,7210,131800,"5588,429",2413,114,2351,39,1025,,0,1326,1326,"0,0%",409,10785
28/07/2020,2020-06-28,2020/07/06,6334,138134,"5833,143",2456,89,2440,0,1025,,0,1415,1415,"0,0%",512,11297
29/07/2020,2020-06-29,2020/07/07,6130,144264,"6096,286",2529,150,2590,45,1070,,0,1520,1520,"0,0%",421,11718
30/07/2020,2020-06-30,2020/07/08,6945,151209,6443,2657,26,2616,64,1134,,0,1482,1482,"0,0%",,11718
31/07/2020,2020-07-01,2020/07/09,8124,159333,6791,2749,71,2687,80,1214,,0,1473,1473,"0,0%",,11718
01/08/2020,2020-07-02,2020/07/10,8728,168061,7098,2844,59,2746,0,1214,,0,1532,1532,"0,0%",,11718
02/08/2020,2020-07-03,2020/07/11,9063,177124,"7504,857",2952,70,2816,0,1214,,0,1602,1602,"0,0%",401,12119
03/08/2020,2020-07-04,2020/07/12,10853,187977,"8025,286",3026,64,2880,39,1253,,0,1627,1627,"0,0%",351,12470
04/08/2020,2020-07-05,2020/07/13,8773,196750,"8373,714",3199,22,2902,5,1258,,0,1644,1644,"0,0%",228,12698
05/08/2020,2020-07-06,2020/07/14,8971,205721,"8779,571",3310,56,2958,127,1385,,0,1573,1573,"0,0%",,12698
06/08/2020,2020-07-07,2020/07/15,10134,215855,"9235,143",3502,62,3020,91,1476,,0,1544,1544,"0,0%",,12698
07/08/2020,2020-07-08,2020/07/16,8810,224665,"9333,143",3602,68,3088,0,1476,,0,1612,1612,"0,0%",445,13143
08/08/2020,2020-07-09,2020/07/17,13674,238339,"10039,714",3720,94,3182,89,1565,,0,1617,1617,"0,0%",523,13666
09/08/2020,2020-07-10,2020/07/18,12348,250687,10509,3860,108,3290,42,1607,,0,1683,1683,"0,0%",409,14075
10/08/2020,2020-07-11,2020/07/19,13497,264184,"10886,714",3971,73,3363,27,1634,,0,1729,1729,"0,0%",409,14484
11/08/2020,2020-07-12,2020/07/20,12058,276242,11356,4079,102,3465,86,1720,,0,1745,1745,"0,0%",531,15015
12/08/2020,2020-07-13,2020/07/21,11554,287796,11725,4172,118,3583,190,1910,,0,1673,1673,"0,0%",603,15618
13/08/2020,2020-07-14,2020/07/22,10496,298292,"11776,714",4346,75,3658,81,1991,,0,1667,1667,"0,0%",543,16161
14/08/2020,2020-07-15,2020/07/23,12757,311049,"12340,571",4453,71,3729,102,2093,,0,1636,1636,"0,0%",419,16580
15/08/2020,2020-07-16,2020/07/24,13172,324221,"12268,857",4669,75,3804,175,2268,,0,1536,1536,"0,0%",405,16985
16/08/2020,2020-07-17,2020/07/25,13373,337594,"12415,286",4804,93,3897,0,2268,,0,1629,1629,"0,0%",510,17495
17/08/2020,2020-07-18,2020/07/26,13285,350879,12385,4948,58,3955,103,2371,,0,1584,1584,"0,0%",415,17910
18/08/2020,2020-07-19,2020/07/27,13449,364328,"12583,714",5033,96,4051,216,2587,,0,1464,1464,"0,0%",419,18329
19/08/2020,2020-07-20,2020/07/28,9300,373628,"12261,714",5173,70,4121,24,2611,,0,1510,1510,"0,0%",406,18735
20/08/2020,2020-07-21,2020/07/29,8170,381798,"11929,429",5368,53,4174,32,2643,,0,1531,1531,"0,0%",360,19095
21/08/2020,2020-07-22,2020/07/30,13150,394948,"11985,571",5940,20,4194,39,2682,,0,1512,1512,"0,0%",,19095
22/08/2020,2020-07-23,2020/07/31,13104,408052,"11975,857",6093,61,4255,80,2762,,0,1493,1493,"0,0%",378,19473
23/08/2020,2020-07-24,2020/08/01,13944,421996,"12057,429",6343,36,4291,136,2898,,0,1393,1393,"0,0%",314,19787
24/08/2020,2020-07-25,2020/08/02,12204,434200,11903,6655,80,4371,38,2936,,0,1435,1435,"0,0%",318,20105
25/08/2020,2020-07-26,2020/08/03,11233,445433,"11586,429",6769,23,4394,23,2959,,0,1435,1435,"0,0%",325,20430
26/08/2020,2020-07-27,2020/08/04,7096,452529,"11271,571",7067,62,4456,119,3078,,0,1378,1378,"0,0%",320,20750
27/08/2020,2020-07-28,2020/08/05,7232,459761,"11137,571",7257,46,4502,37,3115,,0,1387,1387,"0,0%",340,21090
28/08/2020,2020-07-29,2020/08/06,11362,471123,"10882,143",7497,29,4531,95,3210,,0,1321,1321,"0,0%",370,21460
29/08/2020,2020-07-30,2020/08/07,11046,482169,"10588,143",7812,49,4580,149,3359,,0,1221,1221,"0,0%",328,21788
30/08/2020,2020-07-31,2020/08/08,11014,493183,"10169,571",8005,51,4631,119,3478,,0,1153,1153,"0,0%",312,22100
31/08/2020,2020-08-01,2020/08/09,10107,503290,9870,8153,16,4647,51,3529,,0,1118,1118,"0,0%",311,22411
01/09/2020,2020-08-02,2020/08/10,8195,511485,9436,8366,45,4692,33,3562,,0,1130,1130,"0,0%",320,22731
02/09/2020,2020-08-03,2020/08/11,5377,516862,"9190,429",8539,51,4743,23,3585,,0,1158,1158,"0,0%",333,23064
03/09/2020,2020-08-04,2020/08/12,4456,521318,"8793,857",8884,52,4795,204,3789,,0,1006,1006,"0,0%",372,23436
04/09/2020,2020-08-05,2020/08/13,8559,529877,"8393,429",9298,60,4855,55,3844,,0,1011,1011,"0,0%",430,23866
05/09/2020,2020-08-06,2020/08/14,8307,538184,"8002,143",9604,39,4894,59,3903,,0,991,991,"0,0%",300,24166
06/09/2020,2020-08-07,2020/08/15,7292,545476,"7470,429",9909,34,4928,48,3951,,0,977,977,"0,0%",310,24476
07/09/2020,2020-08-08,2020/08/16,7712,553188,"7128,286",10210,31,4959,78,4029,,0,930,930,"0,0%",300,24776
08/09/2020,2020-08-09,2020/08/17,6671,559859,"6910,571",10408,20,4979,30,4059,,0,920,920,"0,0%",172,24948
09/09/2020,2020-08-10,2020/08/18,3739,563598,"6676,571",10621,32,5011,18,4077,,0,934,934,"0,0%",208,25156
10/09/2020,2020-08-11,2020/08/19,2511,566109,"6398,714",10751,58,5069,26,4103,,0,966,966,"0,0%",328,25484
11/09/2020,2020-08-12,2020/08/20,2810,568919,"5577,429",11010,31,5100,62,4165,,0,935,935,"0,0%",290,25774
12/09/2020,2020-08-13,2020/08/21,3946,572865,"4954,429",11270,25,5125,23,4188,,0,937,937,"0,0%",201,25975
13/09/2020,2020-08-14,2020/08/22,6275,579140,"4809,143",11556,25,5150,41,4229,,0,921,921,"0,0%",218,26193
14/09/2020,2020-08-15,2020/08/23,4513,583653,"4352,143",11677,31,5181,145,4374,,0,807,807,"0,0%",198,26391
15/09/2020,2020-08-16,2020/08/24,3692,587345,"3926,571",11839,25,5206,27,4401,,0,805,805,"0,0%",167,26558
16/09/2020,2020-08-17,2020/08/25,2541,589886,"3755,429",11982,27,5233,17,4418,,0,815,815,"0,0%",174,26732
17/09/2020,2020-08-18,2020/08/26,2258,592144,"3719,286",12264,36,5269,21,4439,,0,830,830,"0,0%",166,26898
18/09/2020,2020-08-19,2020/08/27,3916,596060,"3877,286",12423,24,5293,39,4478,,0,815,815,"0,0%",161,27059
19/09/2020,2020-08-20,2020/08/28,3880,599940,"3867,857",12618,30,5323,93,4571,,0,752,752,"0,0%",181,27240
20/09/2020,2020-08-21,2020/08/29,3398,603338,"3456,857",12843,25,5348,53,4624,,0,724,724,"0,0%",203,27443
21/09/2020,2020-08-22,2020/08/30,3707,607045,"3341,714",12987,13,5361,23,4647,,0,714,714,"0,0%",103,27546
22/09/2020,2020-08-23,2020/08/31,2728,609773,3204,13059,25,5386,25,4672,,0,714,714,"0,0%",110,27656
23/09/2020,2020-08-24,2020/09/01,1677,611450,"3080,571",13159,36,5422,21,4693,,0,729,729,"0,0%",196,27852
24/09/2020,2020-08-25,2020/09/02,1567,613017,"2981,857",13308,32,5454,31,4724,,0,730,730,"0,0%",236,28088
25/09/2020,2020-08-26,2020/09/03,2684,615701,"2805,857",13502,24,5478,43,4767,,0,711,711,"0,0%",,28088
26/09/2020,2020-08-27,2020/09/04,2585,618286,"2620,857",13628,20,5498,35,4802,,0,696,696,"0,0%",200,28288
27/09/2020,2020-08-28,2020/09/05,1846,620132,"2399,143",13743,15,5513,19,4821,,0,692,692,"0,0%",142,28430
28/09/2020,2020-08-29,2020/09/06,2419,622551,"2215,143",13981,21,5534,23,4844,,0,690,690,"0,0%",90,28520
29/09/2020,2020-08-30,2020/09/07,2505,625056,"2183,286",14028,10,5544,15,4859,,0,685,685,"0,0%",119,28639
30/09/2020,2020-08-31,2020/09/08,1985,627041,"2227,286",14149,20,5564,53,4912,,0,652,652,"0,0%",,28639
01/10/2020,2020-09-01,2020/09/09,1218,628259,"2177,429",14263,22,5586,88,5000,,0,586,586,"0,0%",237,28876
02/10/2020,2020-09-02,2020/09/10,2336,630595,"2127,714",14389,22,5608,61,5061,,0,547,547,"0,0%",273,29149
03/10/2020,2020-09-03,2020/09/11,2420,633015,"2104,143",14563,9,5617,15,5076,,0,541,541,"0,0%",100,29249
04/10/2020,2020-09-04,2020/09/12,2063,635078,"2135,143",14678,39,5656,51,5127,,0,529,529,"0,0%",277,29526
05/10/2020,2020-09-05,2020/09/13,1806,636884,"2047,571",14779,10,5666,14,5141,,0,525,525,"0,0%",173,29699
06/10/2020,2020-09-06,2020/09/14,1633,638517,1923,14889,19,5685,28,5169,,0,516,516,"0,0%",205,29904
07/10/2020,2020-09-07,2020/09/15,845,639362,"1760,143",15004,20,5705,27,5196,,0,509,509,"0,0%",243,30147
08/10/2020,2020-09-08,2020/09/16,1079,640441,"1740,286",15086,16,5721,35,5231,,0,490,490,"0,0%",271,30418
09/10/2020,2020-09-09,2020/09/17,1990,642431,"1690,857",15168,13,5734,23,5254,,0,480,480,"0,0%",259,30677
10/10/2020,2020-09-10,2020/09/18,2007,644438,"1631,857",15265,16,5750,28,5282,,0,468,468,"0,0%",250,30927
11/10/2020,2020-09-11,2020/09/19,1960,646398,"1617,143",15378,9,5759,28,5310,,0,449,449,"0,0%",245,31172
12/10/2020,2020-09-12,2020/09/20,1816,648214,"1618,571",15427,16,5775,12,5322,,0,453,453,"0,0%",179,31351
13/10/2020,2020-09-13,2020/09/21,1579,649793,"1610,857",15447,13,5788,15,5337,,0,451,451,"0,0%",269,31620
14/10/2020,2020-09-14,2020/09/22,956,650749,"1626,714",15499,20,5808,10,5347,,0,461,461,"0,0%",326,31946
15/10/2020,2020-09-15,2020/09/23,772,651521,"1582,857",15641,21,5829,28,5375,,0,454,454,"0,0%",370,32316
16/10/2020,2020-09-16,2020/09/24,1923,653444,"1573,286",15705,14,5843,17,5392,,0,451,451,"0,0%",465,32781
17/10/2020,2020-09-17,2020/09/25,2128,655572,"1590,571",15772,19,5862,0,5392,,0,470,470,"0,0%",349,33130
18/10/2020,2020-09-18,2020/09/26,2055,657627,"1604,143",15857,15,5877,23,5415,,0,462,462,"0,0%",245,33375
19/10/2020,2020-09-19,2020/09/27,2029,659656,"1634,571",15940,8,5885,12,5427,,0,458,458,"0,0%",242,33617
20/10/2020,2020-09-20,2020/09/28,1555,661211,"1631,143",15953,12,5897,10,5437,,0,460,460,"0,0%",300,33917
21/10/2020,2020-09-21,2020/09/29,725,661936,"1598,143",15992,5,5902,16,5453,,0,449,449,"0,0%",250,34167
22/10/2020,2020-09-22,2020/09/30,1346,663282,"1680,143",16118,9,5911,15,5468,,0,443,443,"0,0%",345,34512
23/10/2020,2020-09-23,2020/10/01,1906,665188,"1677,714",16206,17,5928,17,5485,,0,443,443,"0,0%",250,34762
24/10/2020,2020-09-24,2020/10/02,1861,667049,"1639,571",16283,16,5944,6,5491,,0,453,453,"0,0%",301,35063
25/10/2020,2020-09-25,2020/10/03,1480,668529,"1557,429",16312,7,5951,11,5502,,0,449,449,"0,0%",318,35381
26/10/2020,2020-09-26,2020/10/04,969,669498,1406,16376,9,5960,9,5511,,0,449,449,"0,0%",200,35581
27/10/2020,2020-09-27,2020/10/05,1268,670766,1365,16398,12,5972,13,5524,,0,448,448,"0,0%",306,35887
28/10/2020,2020-09-28,2020/10/06,903,671669,"1390,429",16586,11,5983,18,5542,,0,441,441,"0,0%",332,36219
29/10/2020,2020-09-29,2020/10/07,903,672572,"1327,143",16667,13,5996,0,5542,,0,454,454,"0,0%",398,36617
30/10/2020,2020-09-30,2020/10/08,1767,674339,"1307,286",16734,11,6007,15,5557,,0,450,450,"0,0%",392,37009
31/10/2020,2020-10-01,2020/10/09,1745,676084,"1290,714",16866,8,6015,89,5646,,0,369,369,"0,0%",569,37578
01/11/2020,2020-10-02,2020/10/10,1749,677833,"1329,143",16909,8,6023,6,5652,,0,371,371,"0,0%",423,38001
02/11/2020,2020-10-03,2020/10/11,1883,679716,"1459,714",16938,4,6027,5,5657,,0,370,370,"0,0%",397,38398
03/11/2020,2020-10-04,2020/10/12,1573,681289,"1503,286",16976,13,6040,12,5669,,0,371,371,"0,0%",440,38838
04/11/2020,2020-10-05,2020/10/13,926,682215,"1506,571",17016,14,6054,17,5686,,0,368,368,"0,0%",346,39184
05/11/2020,2020-10-06,2020/10/14,1027,683242,"1524,286",17103,13,6067,8,5694,,0,373,373,"0,0%",453,39637
06/11/2020,2020-10-07,2020/10/15,1913,685155,"1545,143",17248,9,6076,10,5704,,0,372,372,"0,0%",365,40002
07/11/2020,2020-10-08,2020/10/16,1736,686891,"1543,857",17408,13,6089,15,5719,,0,370,370,"0,0%",329,40331
08/11/2020,2020-10-09,2020/10/17,1461,688352,"1502,714",17547,14,6103,5,5724,,0,379,379,"0,0%",335,40666
09/11/2020,2020-10-10,2020/10/18,2544,690896,"1597,143",17673,11,6114,8,5732,,0,382,382,"0,0%",225,40891
10/11/2020,2020-10-11,2020/10/19,1575,692471,"1597,429",17780,11,6125,5,5737,,0,388,388,"0,0%",469,41360
11/11/2020,2020-10-12,2020/10/20,888,693359,1592,17863,20,6145,7,5744,,0,401,401,"0,0%",494,41854
12/11/2020,2020-10-13,2020/10/21,1178,694537,"1613,571",18028,16,6161,2,5746,,0,415,415,"0,0%",,41854
13/11/2020,2020-10-14,2020/10/22,1877,696414,"1608,429",18151,18,6179,10,5756,,0,423,423,"0,0%",444,42298
14/11/2020,2020-10-15,2020/10/23,1770,698184,"1613,286",18309,17,6196,15,5771,,0,425,425,"0,0%",324,42622
15/11/2020,2020-10-16,2020/10/24,2019,700203,1693,18370,2,6198,8,5779,,0,419,419,"0,0%",384,43006
16/11/2020,2020-10-17,2020/10/25,1928,702131,1605,18408,12,6210,11,5790,,0,420,420,"0,0%",277,43283
17/11/2020,2020-10-18,2020/10/26,1662,703793,"1617,429",18471,23,6233,22,5812,,0,421,421,"0,0%",432,43715
18/11/2020,2020-10-19,2020/10/27,1461,705254,"1699,286",18492,25,6258,14,5826,,0,432,432,"0,0%",404,44119
19/11/2020,2020-10-20,2020/10/28,1050,706304,1681,18656,12,6270,5,5831,,0,439,439,"0,0%",422,44541
20/11/2020,2020-10-21,2020/10/29,2055,708359,"1706,429",18741,29,6299,8,5839,,0,460,460,"0,0%",456,44997
21/11/2020,2020-10-22,2020/10/30,2156,710515,"1761,571",18843,20,6319,11,5850,,0,469,469,"0,0%",379,45376
22/11/2020,2020-10-23,2020/10/31,1897,712412,"1744,143",18891,14,6333,8,5858,,0,475,475,"0,0%",354,45730
23/11/2020,2020-10-24,2020/11/01,1834,714246,"1730,714",18944,14,6347,11,5869,,0,478,478,"0,0%",238,45968
24/11/2020,2020-10-25,2020/11/02,1622,715868,1725,18968,14,6361,9,5878,,0,483,483,"0,0%",436,46404
25/11/2020,2020-10-26,2020/11/03,891,716759,"1643,571",19008,25,6386,23,5901,,0,485,485,"0,0%",497,46901
26/11/2020,2020-10-27,2020/11/04,1092,717851,"1649,571",19053,57,6443,28,5929,,0,514,514,"0,0%",442,47343
27/11/2020,2020-10-28,2020/11/05,1863,719714,"1622,143",19111,34,6477,30,5959,,0,518,518,"0,0%",591,47934
28/11/2020,2020-10-29,2020/11/06,2056,721770,"1607,857",19164,44,6521,28,5987,,0,534,534,"0,0%",410,48344
29/11/2020,2020-10-30,2020/11/07,1912,723682,1610,19230,4,6525,9,5996,,0,529,529,"0,0%",339,48683
30/11/2020,2020-10-31,2020/11/08,1770,725452,"1600,857",19276,9,6534,10,6006,,0,528,528,"0,0%",252,48935
01/12/2020,2020-11-01,2020/11/09,1371,726823,1565,19411,23,6557,11,6017,,0,540,540,"0,0%",411,49346
02/12/2020,2020-11-02,2020/11/10,772,727595,1548,19465,15,6572,15,6032,,0,540,540,"0,0%",439,49785
03/12/2020,2020-11-03,2020/11/11,1241,728836,"1569,286",19539,19,6591,12,6044,,0,547,547,"0,0%",493,50278
04/12/2020,2020-11-04,2020/11/12,1712,730548,"1547,714",19585,6,6597,22,6066,,0,531,531,"0,0%",515,50793
05/12/2020,2020-11-05,2020/11/13,1866,732414,"1520,571",19677,15,6612,12,6078,,0,534,534,"0,0%",346,51139
06/12/2020,2020-11-06,2020/11/14,1761,734175,1499,19749,6,6618,12,6090,,0,528,528,"0,0%",395,51534
07/12/2020,2020-11-07,2020/11/15,1731,735906,"1493,429",19789,28,6646,4,6094,,0,552,552,"0,0%",,51534
08/12/2020,2020-11-08,2020/11/16,1372,737278,"1493,571",19809,35,6681,43,6137,,0,544,544,"0,0%",465,51999
09/12/2020,2020-11-09,2020/11/17,1247,738525,"1561,429",19845,49,6730,38,6175,,0,555,555,"0,0%",681,52680
10/12/2020,2020-11-10,2020/11/18,1729,740254,"1631,143",19951,21,6751,46,6221,,0,530,530,"0,0%",542,53222
11/12/2020,2020-11-11,2020/11/19,2140,742394,"1692,286",20011,55,6806,58,6279,,0,527,527,"0,0%",467,53689
12/12/2020,2020-11-12,2020/11/20,2338,744732,"1759,714",20076,30,6836,52,6331,,0,505,505,"0,0%",596,54285
13/12/2020,2020-11-13,2020/11/21,2213,746945,"1824,286",20153,55,6891,48,6379,,0,512,512,"0,0%",518,54803
14/12/2020,2020-11-14,2020/11/22,2237,749182,"1896,571",20206,63,6954,37,6416,,0,538,538,"0,0%",516,55319
15/12/2020,2020-11-15,2020/11/23,1842,751024,"1963,714",20241,91,7045,60,6476,,0,569,569,"0,0%",753,56072
16/12/2020,2020-11-16,2020/11/24,1245,752269,"1963,429",20314,121,7166,55,6531,,0,635,635,"0,0%",905,56977
17/12/2020,2020-11-17,2020/11/25,1987,754256,"2000,286",20432,79,7245,48,6579,,0,666,666,"0,0%",1087,58064
18/12/2020,2020-11-18,2020/11/26,2888,757144,"2107,143",20556,111,7356,45,6624,,0,732,732,"0,0%",991,59055
19/12/2020,2020-11-19,2020/11/27,2514,759658,"2132,286",20671,108,7464,38,6662,,0,802,802,"0,0%",1070,60125
20/12/2020,2020-11-20,2020/11/28,3105,762763,"2259,714",20759,124,7588,34,6696,,0,892,892,"0,0%",,60125
21/12/2020,2020-11-21,2020/11/29,2646,765409,"2318,143",20845,144,7732,65,6761,,0,971,971,"0,0%",774,60899
22/12/2020,2020-11-22,2020/11/30,2270,767679,"2379,286",20903,154,7886,60,6821,,0,1065,1065,"0,0%",,60899
23/12/2020,2020-11-23,2020/12/01,2080,769759,"2498,571",20968,168,8054,58,6879,,0,1175,1175,"0,0%",1122,62021
24/12/2020,2020-11-24,2020/12/02,2493,772252,"2570,857",21083,170,8224,73,6952,,0,1272,1272,"0,0%",1175,63196
25/12/2020,2020-11-25,2020/12/03,3250,775502,"2622,571",21201,138,8362,64,7016,,0,1346,1346,"0,0%",1514,64710
26/12/2020,2020-11-26,2020/12/04,3069,778571,"2701,857",21289,206,8568,0,7016,,0,1552,1552,"0,0%",1222,65932
27/12/2020,2020-11-27,2020/12/05,3370,781941,"2739,714",21378,124,8692,0,7016,,0,1676,1676,"0,0%",1322,67254
28/12/2020,2020-11-28,2020/12/06,3198,785139,"2818,571",21439,216,8908,10,7026,,0,1882,1882,"0,0%",1308,68562
29/12/2020,2020-11-29,2020/12/07,2563,787702,"2860,429",21477,261,9169,22,7048,,0,2121,2121,"0,0%",1665,70227
30/12/2020,2020-11-30,2020/12/08,2302,790004,"2892,143",21535,237,9406,14,7062,,0,2344,2344,"0,0%",1738,71965
31/12/2020,2020-12-01,2020/12/09,2295,792299,"2863,857",21644,219,9625,11,7073,,0,2552,2552,"0,0%",1470,73435
01/01/2021,2020-12-02,2020/12/10,4173,796472,"2995,714",21709,191,9816,0,7073,,0,2743,2743,"0,0%",1273,74708
02/01/2021,2020-12-03,2020/12/11,4400,800872,"3185,857",21803,251,10067,23,7096,,0,2971,2971,"0,0%",1292,76000
03/01/2021,2020-12-04,2020/12/12,4932,805804,3409,21963,245,10312,17,7113,,0,3199,3199,"0,0%",1387,77387
04/01/2021,2020-12-05,2020/12/13,4645,810449,"3615,714",22067,246,10558,10,7123,,0,3435,3435,"0,0%",1274,78661
05/01/2021,2020-12-06,2020/12/14,4116,814565,"3837,571",22206,241,10799,11,7134,,0,3665,3665,"0,0%",1422,80083
06/01/2021,2020-12-07,2020/12/15,3313,817878,3982,22249,234,11033,120,7254,,0,3779,3779,"0,0%",1644,81727
07/01/2021,2020-12-08,2020/12/16,4011,821889,"4227,143",22432,275,11308,123,7377,,0,3931,3931,"0,0%",1366,83093
08/01/2021,2020-12-09,2020/12/17,6709,828598,"4589,429",22574,253,11561,117,7494,,0,4067,4067,"0,0%",2336,85429
09/01/2021,2020-12-10,2020/12/18,8166,836764,"5127,429",22747,225,11786,98,7592,,0,4194,4194,"0,0%",1853,87282
10/01/2021,2020-12-11,2020/12/19,8319,845083,"5611,286",22952,269,12055,84,7676,,0,4379,4379,"0,0%",1253,88535
11/01/2021,2020-12-12,2020/12/20,7882,852965,"6073,714",23106,314,12369,98,7774,,0,4595,4595,"0,0%",1128,89663
12/01/2021,2020-12-13,2020/12/21,7999,860964,"6628,429",23276,252,12621,124,7898,,0,4723,4723,"0,0%",1416,91079
13/01/2021,2020-12-14,2020/12/22,5163,866127,"6892,714",23451,230,12851,88,7986,,0,4865,4865,"0,0%",1493,92572
14/01/2021,2020-12-15,2020/12/23,7552,873679,"7398,571",23661,225,13076,90,8076,,0,5000,5000,"0,0%",1653,94225
15/01/2021,2020-12-16,2020/12/24,10008,883687,"7869,857",23827,230,13306,0,8076,,0,5230,5230,"0,0%",,94225
16/01/2021,2020-12-17,2020/12/25,9126,892813,8007,24011,223,13529,0,8076,,0,5453,5453,"0,0%",,94225
17/01/2021,2020-12-18,2020/12/26,8725,901538,8065,24285,215,13744,146,8222,,0,5522,5522,"0,0%",1410,95635
18/01/2021,2020-12-19,2020/12/27,10939,912477,"8501,714",24539,267,14011,152,8374,,0,5637,5637,"0,0%",1268,96903
19/01/2021,2020-12-20,2020/12/28,9445,921922,"8708,286",24691,277,14288,138,8512,,0,5776,5776,"0,0%",1289,98192
20/01/2021,2020-12-21,2020/12/29,8789,930711,"9226,286",24907,361,14649,140,8652,,0,5997,5997,"0,0%",1208,99400
21/01/2021,2020-12-22,2020/12/30,9501,940212,"9504,714",25246,234,14883,170,8822,,0,6061,6061,"0,0%",1345,100745
22/01/2021,2020-12-23,2020/12/31,14046,954258,"10081,571",25657,220,15103,140,8962,,0,6141,6141,"0,0%",1412,102157
23/01/2021,2020-12-24,2021/01/01,14305,968563,"10821,429",25983,114,15217,140,9102,,0,6115,6115,"0,0%",1177,103334
24/01/2021,2020-12-25,2021/01/02,14796,983359,"11688,714",26276,161,15378,140,9242,,0,6136,6136,"0,0%",1092,104426
25/01/2021,2020-12-26,2021/01/03,11552,994911,"11776,286",26521,150,15528,152,9394,,0,6134,6134,"0,0%",448,104874
26/01/2021,2020-12-27,2021/01/04,9502,1004413,"11784,429",26735,214,15742,148,9542,,0,6200,6200,"0,0%",1118,105992
27/01/2021,2020-12-28,2021/01/05,7458,1011871,"11594,286",27071,230,15972,158,9700,,0,6272,6272,"0,0%",1413,107405
28/01/2021,2020-12-29,2021/01/06,9580,1021451,"11605,571",27568,235,16207,133,9833,,0,6374,6374,"0,0%",1234,108639
29/01/2021,2020-12-30,2021/01/07,17710,1039161,12129,28033,190,16397,195,10028,,0,6369,6369,"0,0%",1276,109915
30/01/2021,2020-12-31,2021/01/08,18000,1057161,"12656,857",28469,197,16594,210,10238,,0,6356,6356,"0,0%",1022,110937
31/01/2021,2021-01-01,2021/01/09,16726,1073887,"12932,571",28887,45,16639,240,10478,,0,6161,6161,"0,0%",1245,112182
01/02/2021,2021-01-02,2021/01/10,15002,1088889,"13425,429",29175,103,16742,172,10650,,0,6092,6092,"0,0%",926,113108
02/02/2021,2021-01-03,2021/01/11,11859,1100748,"13762,143",29577,82,16824,189,10839,,0,5985,5985,"0,0%",1188,114296
03/02/2021,2021-01-04,2021/01/12,12601,1113349,"14496,857",30011,102,16926,160,10999,,0,5927,5927,"0,0%",902,115198
04/02/2021,2021-01-05,2021/01/13,14410,1127759,"15186,857",30524,72,16998,123,11122,,0,5876,5876,"0,0%",1037,116235
05/02/2021,2021-01-06,2021/01/14,21832,1149591,"15775,714",31368,96,17094,167,11289,,0,5805,5805,"0,0%",968,117203
06/02/2021,2021-01-07,2021/01/15,20999,1170590,"16204,143",31809,49,17143,180,11469,,0,5674,5674,"0,0%",782,117985
07/02/2021,2021-01-08,2021/01/16,21980,1192570,"16954,714",32425,24,17167,145,11614,,0,5553,5553,"0,0%",592,118577
08/02/2021,2021-01-09,2021/01/17,21606,1214176,"17898,143",32824,31,17198,105,11719,,0,5479,5479,"0,0%",486,119063
09/02/2021,2021-01-10,2021/01/18,17421,1231597,"18692,714",33163,54,17252,138,11857,,0,5395,5395,"0,0%",1089,120152
10/02/2021,2021-01-11,2021/01/19,15046,1246643,19042,33579,56,17308,98,11955,,0,5353,5353,"0,0%",780,120932
11/02/2021,2021-01-12,2021/01/20,13105,1259748,"18855,571",34334,56,17364,81,12036,,0,5328,5328,"0,0%",778,121710
12/02/2021,2021-01-13,2021/01/21,18555,1278303,"18387,429",35140,59,17423,104,12140,,0,5283,5283,"0,0%",862,122572
13/02/2021,2021-01-14,2021/01/22,18503,1296806,"18030,857",35852,33,17456,56,12196,,0,5260,5260,"0,0%",630,123202
14/02/2021,2021-01-15,2021/01/23,14880,1311686,"17016,571",36467,47,17503,56,12252,,0,5251,5251,"0,0%",562,123764
15/02/2021,2021-01-16,2021/01/24,13973,1325659,"15926,143",36851,42,17545,182,12434,,0,5111,5111,"0,0%",506,124270
16/02/2021,2021-01-17,2021/01/25,12267,1337926,"15189,857",37105,30,17575,76,12510,,0,5065,5065,"0,0%",573,124843
17/02/2021,2021-01-18,2021/01/26,9010,1346936,"14327,571",37449,68,17643,104,12614,,0,5029,5029,"0,0%",802,125645
18/02/2021,2021-01-19,2021/01/27,9780,1356716,"13852,571",38288,37,17680,124,12738,,0,4942,4942,"0,0%",894,126539
19/02/2021,2021-01-20,2021/01/28,12710,1369426,"13017,571",38854,34,17714,158,12896,,0,4818,4818,"0,0%",864,127403
20/02/2021,2021-01-21,2021/01/29,11381,1380807,"12000,143",39501,22,17736,215,13111,,0,4625,4625,"0,0%",944,128347
21/02/2021,2021-01-22,2021/01/30,11761,1392568,"11554,571",40076,25,17761,211,13322,,0,4439,4439,"0,0%",437,128784
22/02/2021,2021-01-23,2021/01/31,12271,1404839,"11311,429",40574,19,17780,220,13542,,0,4238,4238,"0,0%",503,129287
23/02/2021,2021-01-24,2021/02/01,8147,1412986,"10722,857",40874,32,17812,198,13740,,0,4072,4072,"0,0%",1267,130554
24/02/2021,2021-01-25,2021/02/02,4551,1417537,"10085,857",41117,58,17870,188,13928,,0,3942,3942,"0,0%",828,131382
25/02/2021,2021-01-26,2021/02/03,6041,1423578,"9551,714",41797,50,17920,230,14158,,0,3762,3762,"0,0%",610,131992
26/02/2021,2021-01-27,2021/02/04,7070,1430648,8746,42550,26,17946,210,14368,,0,3578,3578,"0,0%",696,132688
27/02/2021,2021-01-28,2021/02/05,7150,1437798,"8141,571",43105,30,17976,205,14573,,0,3403,3403,"0,0%",678,133366
28/02/2021,2021-01-29,2021/02/06,6141,1443939,"7338,714",43633,12,17988,230,14803,,0,3185,3185,"0,0%",459,133825
01/03/2021,2021-01-30,2021/02/07,5297,1449236,"6342,429",43951,47,18035,124,14927,,0,3108,3108,"0,0%",341,134166
02/03/2021,2021-01-31,2021/02/08,4525,1453761,5825,44164,61,18096,98,15025,,0,3071,3071,"0,0%",1055,135221
03/03/2021,2021-02-01,2021/02/09,2548,1456309,"5538,857",44399,17,18113,54,15079,,0,3034,3034,"0,0%",882,136103
04/03/2021,2021-02-02,2021/02/10,2649,1458958,"5054,286",44946,27,18140,532,15611,,0,2529,2529,"0,0%",705,136808
05/03/2021,2021-02-03,2021/02/11,4058,1463016,4624,45344,26,18166,92,15703,,0,2463,2463,"0,0%",831,137639
06/03/2021,2021-02-04,2021/02/12,3751,1466767,"4138,429",45605,18,18184,80,15783,,0,2401,2401,"0,0%",549,138188
07/03/2021,2021-02-05,2021/02/13,3749,1470516,"3796,714",45902,13,18197,65,15848,,0,2349,2349,"0,0%",490,138678
08/03/2021,2021-02-06,2021/02/14,3184,1473700,"3494,857",46180,4,18201,196,16044,,0,2157,2157,"0,0%",357,139035
09/03/2021,2021-02-07,2021/02/15,2435,1476135,"3196,286",46290,3,18204,105,16149,,0,2055,2055,"0,0%",891,139926
10/03/2021,2021-02-08,2021/02/16,1376,1477511,"3028,857",46473,12,18216,65,16214,,0,2002,2002,"0,0%",899,140825
11/03/2021,2021-02-09,2021/02/17,1742,1479253,"2899,286",46869,12,18228,54,16268,,0,1960,1960,"0,0%",533,141358
12/03/2021,2021-02-10,2021/02/18,3159,1482412,"2770,857",47145,10,18238,55,16323,,0,1915,1915,"0,0%",520,141878
13/03/2021,2021-02-11,2021/02/19,2488,1484900,"2590,429",47382,10,18248,122,16445,,0,1803,1803,"0,0%",501,142379
14/03/2021,2021-02-12,2021/02/20,2781,1487681,"2452,143",47670,3,18251,80,16525,,0,1726,1726,"0,0%",366,142745
15/03/2021,2021-02-13,2021/02/21,2382,1490063,"2337,571",47821,2,18253,43,16568,,0,1685,1685,"0,0%",784,143529
16/03/2021,2021-02-14,2021/02/22,1744,1491807,"2238,857",47899,4,18257,50,16618,,0,1639,1639,"0,0%",914,144443
17/03/2021,2021-02-15,2021/02/23,1102,1492909,"2199,714",48094,14,18271,44,16662,,0,1609,1609,"0,0%",659,145102
18/03/2021,2021-02-16,2021/02/24,1210,1494119,"2123,714",48313,10,18281,51,16713,,0,1568,1568,"0,0%",584,145686
19/03/2021,2021-02-17,2021/02/25,2320,1496439,"2003,857",48478,7,18288,45,16758,,0,1530,1530,"0,0%",613,146299
20/03/2021,2021-02-18,2021/02/26,2327,1498766,"1980,857",48708,12,18300,40,16798,,0,1502,1502,"0,0%",459,146758
21/03/2021,2021-02-19,2021/02/27,1911,1500677,"1856,571",48859,3,18303,23,16821,,0,1482,1482,"0,0%",397,147155
22/03/2021,2021-02-20,2021/02/28,1690,1502367,"1757,714",48940,4,18307,218,17039,,0,1268,1268,"0,0%",509,147664
23/03/2021,2021-02-21,2021/03/01,1429,1503796,"1712,714",49053,6,18313,34,17073,,0,1240,1240,"0,0%",746,148410
24/03/2021,2021-02-22,2021/03/02,792,1504588,"1668,429",49150,5,18318,74,17147,,0,1171,1171,"0,0%",775,149185
25/03/2021,2021-02-23,2021/03/03,998,1505586,"1638,143",49413,5,18323,75,17222,,0,1101,1101,"0,0%",620,149805
26/03/2021,2021-02-24,2021/03/04,1862,1507448,"1572,714",49523,6,18329,63,17285,,0,1044,1044,"0,0%",464,150269
27/03/2021,2021-02-25,2021/03/05,1676,1509124,"1479,714",49667,6,18335,76,17361,,0,974,974,"0,0%",583,150852
28/03/2021,2021-02-26,2021/03/06,1654,1510778,1443,49784,3,18338,24,17385,,0,953,953,"0,0%",421,151273
29/03/2021,2021-02-27,2021/03/07,1447,1512225,"1408,286",49941,5,18343,14,17399,,0,944,944,"0,0%",489,151762
30/03/2021,2021-02-28,2021/03/08,1168,1513393,1371,49993,7,18350,54,17453,,0,897,897,"0,0%",1135,152897
31/03/2021,2021-03-01,2021/03/09,566,1513959,"1338,714",50077,4,18354,47,17500,,0,854,854,"0,0%",533,153430
01/04/2021,2021-03-02,2021/03/10,856,1514815,"1318,429",50271,7,18361,16,17516,,0,845,845,"0,0%",495,153925
02/04/2021,2021-03-03,2021/03/11,1447,1516262,"1259,143",50366,3,18364,24,17540,,0,824,824,"0,0%",533,154458
03/04/2021,2021-03-04,2021/03/12,1404,1517666,"1220,286",50462,2,18366,37,17577,,0,789,789,"0,0%",425,154883
04/04/2021,2021-03-05,2021/03/13,1313,1518979,"1171,571",50566,3,18369,11,17588,,0,781,781,"0,0%",508,155391
05/04/2021,2021-03-06,2021/03/14,1227,1520206,"1140,143",50647,2,18371,2,17590,,0,781,781,"0,0%",324,155715
06/04/2021,2021-03-07,2021/03/15,862,1521068,"1096,429",50678,4,18375,5,17595,,0,780,780,"0,0%",623,156338
07/04/2021,2021-03-08,2021/03/16,638,1521706,"1106,714",50803,7,18382,8,17603,,0,779,779,"0,0%",698,157036
08/04/2021,2021-03-09,2021/03/17,991,1522697,1126,50906,2,18384,8,17611,,0,773,773,"0,0%",645,157681
09/04/2021,2021-03-10,2021/03/18,1477,1524174,"1130,286",51015,3,18387,3,17614,,0,773,773,"0,0%",509,158190
10/04/2021,2021-03-11,2021/03/19,1474,1525648,"1140,286",51110,3,18390,3,17617,669,669,104,104,"3,6%",590,158780
11/04/2021,2021-03-12,2021/03/20,1225,1526873,"1127,714",51179,3,18393,65,17682,0,669,42,42,"3,6%",578,159358
12/04/2021,2021-03-13,2021/03/21,1541,1528414,"1172,571",51261,1,18394,0,17682,0,669,43,43,"3,6%",512,159870
13/04/2021,2021-03-14,2021/03/22,1006,1529420,"1193,143",51326,8,18402,9,17691,0,669,42,42,"3,6%",918,160788
14/04/2021,2021-03-15,2021/03/23,613,1530033,"1189,571",51421,5,18407,6,17697,1,670,40,40,"3,6%",864,161652
15/04/2021,2021-03-16,2021/03/24,933,1530966,"1181,286",51560,5,18412,2,17699,0,670,43,43,"3,6%",818,162470
16/04/2021,2021-03-17,2021/03/25,1531,1532497,1189,51634,2,18414,4,17703,0,670,41,41,"3,6%",1325,163795
17/04/2021,2021-03-18,2021/03/26,1464,1533961,"1187,571",51724,1,18415,7,17710,1,671,34,34,"3,6%",527,164322
18/04/2021,2021-03-19,2021/03/27,1462,1535423,"1221,429",52035,2,18417,2,17712,0,671,34,34,"3,6%",504,164826
19/04/2021,2021-03-20,2021/03/28,1378,1536801,"1198,143",52082,0,18417,3,17715,0,671,31,31,"3,6%",428,165254
20/04/2021,2021-03-21,2021/03/29,1051,1537852,"1204,571",52111,0,18417,3,17718,0,671,28,28,"3,6%",1158,166412
21/04/2021,2021-03-22,2021/03/30,599,1538451,"1202,571",52196,6,18423,3,17721,0,671,31,31,"3,6%",1164,167576
22/04/2021,2021-03-23,2021/03/31,510,1538961,"1142,143",52251,3,18426,1,17722,0,671,33,33,"3,6%",1017,168593
23/04/2021,2021-03-24,2021/04/01,1048,1540009,"1073,143",52372,8,18434,8,17730,0,671,33,33,"3,6%",713,169306
24/04/2021,2021-03-25,2021/04/02,1554,1541563,1086,52535,6,18440,7,17737,0,671,32,32,"3,6%",565,169871
25/04/2021,2021-03-26,2021/04/03,1516,1543079,"1093,714",52602,2,18442,0,17737,0,671,34,34,"3,6%",691,170562
26/04/2021,2021-03-27,2021/04/04,1387,1544466,1095,52648,1,18443,4,17741,0,671,31,31,"3,6%",725,171287
27/04/2021,2021-03-28,2021/04/05,965,1545431,"1082,714",52663,5,18448,0,17741,0,671,36,36,"3,6%",648,171935
28/04/2021,2021-03-29,2021/04/06,548,1545979,"1075,429",52710,4,18452,2,17743,0,671,38,38,"3,6%",1331,173266
29/04/2021,2021-03-30,2021/04/07,756,1546735,"1110,571",52788,6,18458,0,17743,0,671,44,44,"3,6%",793,174059
30/04/2021,2021-03-31,2021/04/08,1422,1548157,1164,52846,0,18458,0,17743,0,671,44,44,"3,6%",985,175044
2021/05/01,2021-04-01,,1294,1549451,"1126,857",52897,0,18458,5,17748,0,671,39,39,"3,6%",788,175832
2021/05/02,2021-04-02,,1273,1550724,"1092,143",52946,0,18458,0,17748,0,671,39,39,"3,6%",420,176252
2021/05/03,2021-04-03,,777,1551501,1005,52954,2,18460,10,17758,0,671,31,31,"3,6%",540,176792
2021/05/04,2021-04-04,,463,1551964,"933,286",52987,1,18461,5,17763,0,671,27,27,"3,6%",1044,177836
2021/05/05,2021-04-05,,452,1552416,"919,571",52995,6,18467,5,17768,0,671,28,28,"3,6%",928,178764
2021/05/06,2021-04-06,,437,1552853,874,53032,6,18473,0,17768,0,671,34,34,"3,6%",1023,179787
2021/05/07,2021-04-07,,756,1553609,"778,857",53111,1,18474,5,17773,0,671,30,30,"3,6%",848,180635
2021/05/08,2021-04-08,,1366,1554975,"789,143",53173,3,18477,4,17777,0,671,29,29,"3,6%",582,181217
2021/05/09,2021-04-09,,1267,1556242,"788,286",53226,3,18480,6,17783,0,671,26,26,"3,6%",550,181767
2021/05/10,2021-04-10,,1285,1557527,"860,857",53256,2,18482,1,17784,0,671,27,27,"3,6%",553,182320
2021/05/11,2021-04-11,,931,1558458,"927,714",53322,5,18487,0,17784,0,671,32,32,"3,6%",1068,183388
2021/05/12,2021-04-12,,655,1559113,"956,714",53356,5,18492,0,17784,0,671,37,37,"3,6%",983,184371
2021/05/13,2021-04-13,,847,1559960,"1015,286",53423,5,18497,2,17786,0,671,40,40,"3,6%",838,185209
2021/05/14,2021-04-14,,1599,1561559,"1135,714",53498,14,18511,7,17793,0,671,47,47,"3,6%",1086,186295
2021/05/15,2021-04-15,,1372,1562931,"1136,571",53571,8,18519,6,17799,1,672,48,48,"3,6%",1428,187723
2021/05/16,2021-04-16,,1424,1564355,1159,53663,1,18520,1,17800,0,672,48,48,"3,6%",643,188366
2021/05/17,2021-04-17,,1325,1565680,"1164,714",53711,3,18523,3,17803,0,672,48,48,"3,6%",2300,190666
2021/05/18,2021-04-18,,1089,1566769,"1187,286",53736,2,18525,3,17806,0,672,47,47,"3,6%",581,191247
2021/05/19,2021-04-19,,744,1567513,1200,53757,5,18530,2,17808,0,672,50,50,"3,6%",473,191720
2021/05/20,2021-04-20,,853,1568366,"1200,857",53887,9,18539,11,17819,0,672,48,48,"3,6%",590,192310
2021/05/21,2021-04-21,,1569,1569935,"1196,571",53940,7,18546,5,17824,0,672,50,50,"3,6%",713,193023
2021/05/22,2021-04-22,,1413,1571348,"1202,429",53995,4,18550,5,17829,0,672,49,49,"3,6%",503,193526
2021/05/23,2021-04-23,,1637,1572985,"1232,857",54066,1,18551,4,17833,0,672,46,46,"3,6%",431,193957
2021/05/24,2021-04-24,,1385,1574370,"1241,429",54125,6,18557,12,17845,0,672,40,40,"3,6%",459,194416
2021/05/25,2021-04-25,,1101,1575471,"1243,143",54148,13,18570,9,17854,0,672,44,44,"3,6%",616,195032
2021/05/26,2021-04-26,,849,1576320,"1258,143",54186,2,18572,0,17854,0,672,46,46,"3,6%",625,195657
2021/05/27,2021-04-27,,880,1577200,1262,54237,10,18582,0,17854,0,672,56,56,"3,6%",802,196459
2021/05/28,2021-04-28,,1250,1578450,"1216,429",54285,5,18587,1,17855,0,672,60,60,"3,6%",703,197162
2021/05/29,2021-04-29,,1086,1579536,"1169,714",54331,2,18589,6,17861,0,672,56,56,"3,6%",616,197778
2021/05/30,2021-04-30,,1674,1581210,1175,54350,2,18591,6,17867,1,673,51,51,"3,6%",423,198201
2021/05/31,2021-05-01,,1632,1582842,"1210,286",54406,4,18595,7,17874,0,673,48,48,"3,6%",474,198675
2021/06/01,2021-05-02,,1222,1584064,"1227,571",54417,6,18601,2,17876,0,673,52,52,"3,6%",629,199304
2021/06/02,2021-05-03,,897,1584961,"1234,429",54452,17,18618,6,17882,0,673,63,63,"3,6%",664,199968
2021/06/03,2021-05-04,,1187,1586148,"1278,286",54511,5,18623,4,17886,0,673,64,64,"3,6%",710,200678
2021/06/04,2021-05-05,,2073,1588221,"1395,857",54557,9,18632,8,17894,0,673,65,65,"3,6%",783,201461
2021/06/05,2021-05-06,,2149,1590370,"1547,714",54620,4,18636,2,17896,0,673,67,67,"3,6%",510,201971
2021/06/06,2021-05-07,,2256,1592626,"1630,857",54687,17,18653,7,17903,0,673,77,77,"3,6%",510,202481
2021/06/07,2021-05-08,,0,1592626,"1397,714",54687,11,18664,3,17906,0,673,85,85,"3,6%",403,202884
2021/06/08,2021-05-09,,3969,1596595,"1790,143",54735,16,18680,6,17912,1,674,94,94,"3,6%",660,203544
2021/06/09,2021-05-10,,1129,1597724,"1823,286",54825,14,18694,5,17917,2,676,101,101,"3,6%",664,204208
2021/06/10,2021-05-11,,1548,1599272,"1874,857",54896,11,18705,6,17923,0,676,106,106,"3,6%",654,204862
2021/06/11,2021-05-12,,2759,1602031,"1972,857",54968,18,18723,15,17938,0,676,109,109,"3,6%",741,205603
2021/06/12,2021-05-13,,3221,1605252,2126,55012,9,18732,5,17943,0,676,113,113,"3,6%",504,206107
2021/06/13,2021-05-14,,3141,1608393,"2252,429",55124,4,18736,6,17949,0,676,111,111,"3,6%",423,206530
2021/06/14,2021-05-15,,2750,1611143,"2645,286",55183,10,18746,3,17952,0,676,118,118,"3,6%",501,207031
2021/06/15,2021-05-16,,2585,1613728,"2447,571",55210,8,18754,7,17959,0,676,119,119,"3,6%",544,207575
2021/06/16,2021-05-17,,1757,1615485,"2537,286",55260,14,18768,11,17970,0,676,122,122,"3,6%",714,208289
2021/06/17,2021-05-18,,2355,1617840,"2652,571",55340,16,18784,13,17983,0,676,125,125,"3,6%",823,209112
2021/06/18,2021-05-19,,3522,1621362,"2761,571",55507,16,18800,14,17997,1,677,126,126,"3,6%",592,209704
2021/06/19,2021-05-20,,3641,1625003,"2821,571",55568,11,18811,8,18005,0,677,129,129,"3,6%",425,210129
2021/06/20,2021-05-21,,3332,1628335,"2848,857",55719,2,18813,12,18017,0,677,119,119,"3,6%",414,210543
2021/06/21,2021-05-22,,4236,1632571,"3061,143",55772,18,18831,22,18039,0,677,115,115,"3,6%",476,211019
2021/06/22,2021-05-23,,2894,1635465,"3105,286",55802,23,18854,9,18048,0,677,129,129,"3,6%",711,211730
2021/06/23,2021-05-24,,2383,1637848,"3194,714",55874,44,18898,2,18050,0,677,171,171,"3,6%",789,212519
2021/06/24,2021-05-25,,0,1637848,"2858,286",55976,49,18947,9,18059,1,678,210,210,"3,6%",829,213348
2021/06/25,2021-05-26,,7707,1645555,"3456,143",56077,42,18989,9,18068,0,678,243,243,"3,6%",780,214128
2021/06/26,2021-05-27,,4422,1649977,"3567,714",56170,29,19018,10,18078,0,678,262,262,"3,6%",610,214738
2021/06/27,2021-05-28,,4574,1654551,"3745,143",56293,17,19035,17,18095,0,678,262,262,"3,6%",429,215167
2021/06/28,2021-05-29,,4519,1659070,"3785,571",56363,49,19084,12,18107,0,678,299,299,"3,6%",547,215714
2021/06/29,2021-05-30,,0,1659070,"3372,143",56363,51,19135,,18107,,,,,"0,0%",486,216200
2021/06/30,2021-05-31,,6547,1665617,3967,56506,32,19167,,18107,,,,,"0,0%",347,216547
2021/07/01,2021-06-01,,3614,1669231,"4483,286",56601,12,19179,21,18157,,681,341,,"3,6%",226,216773
2021/07/02,2021-06-02,,5782,1675013,"4208,286",56711,37,19216,37,18194,0,681,341,341,"3,5%",258,217031
2021/07/03,2021-06-03,,5360,1680373,"4342,286",56765,44,19260,13,18207,0,681,372,372,"3,5%",547,217578
2021/07/04,2021-06-04,,5668,1686041,"4498,571",56832,25,19285,48,18255,0,681,349,349,"3,5%",254,217832
2021/07/05,2021-06-05,,5450,1691491,"4631,571",56929,29,19314,16,18271,1,682,361,361,"3,5%",234,218066
2021/07/06,2021-06-06,,5073,1696564,"5356,286",56974,96,19410,52,18323,1,683,404,404,"3,5%",741,218807
2021/07/07,2021-06-07,,3285,1699849,"4890,286",57063,112,19522,15,18338,1,684,500,500,"3,5%",774,219581
2021/07/08,2021-06-08,,4209,1704058,"4975,286",57183,140,19662,42,18380,1,685,597,597,"3,5%",979,220560
2021/07/09,2021-06-09,,8881,1712939,5418,57310,117,19779,44,18424,1,686,669,669,"3,5%",812,221372
2021/07/10,2021-06-10,,9147,1722086,5959,57410,91,19870,31,18455,1,687,728,728,"3,5%",512,221884
2021/07/11,2021-06-11,,8020,1730106,6295,57592,48,19918,11,18466,5,692,760,760,"3,5%",410,222294
2021/07/12,2021-06-12,,9319,1739425,"6847,714",57706,162,20080,29,18495,3,695,890,890,"3,5%",1005,223299
2021/07/13,2021-06-13,,7657,1747082,"7216,857",57765,200,20280,38,18533,1,696,1051,1051,"3,4%",1330,224629
2021/07/14,2021-06-14,,5548,1752630,"7540,143",57879,209,20489,24,18557,0,696,1236,1236,"3,4%",871,225500
2021/07/15,2021-06-15,,8436,1761066,8144,58087,204,20693,28,18585,2,698,1410,1410,"3,4%",983,226483
2021/07/16,2021-06-16,,13246,1774312,"8767,571",58223,205,20898,81,18666,3,701,1531,1531,"3,4%",2353,228836
2021/07/17,2021-06-17,,11767,1786079,"9141,857",58323,164,21062,102,18768,2,703,1591,1591,"3,3%",546,229382
2021/07/18,2021-06-18,,10510,1796589,"9497,571",58441,70,21132,119,18887,9,712,1533,1533,"3,4%",672,230054
2021/07/19,2021-06-19,,13575,1810164,"10105,571",58590,111,21243,100,18987,7,719,1537,1537,"3,4%",849,230903
2021/07/20,2021-06-20,,13155,1823319,10891,58702,253,21496,99,19086,8,727,1683,1683,"3,4%",1395,232298
2021/07/21,2021-06-21,,9160,1832479,11407,58795,240,21736,135,19221,3,730,1785,1785,"3,4%",1396,233694
2021/07/22,2021-06-22,,11093,1843572,"11786,571",59092,144,21880,171,19392,5,735,1753,1753,"3,4%",861,234555
2021/07/23,2021-06-23,,17493,1861065,"12393,286",59258,276,22156,178,19570,7,742,1844,1844,"3,3%",1449,236004
2021/07/24,2021-06-24,,16078,1877143,"13009,143",59406,531,22687,199,19769,5,747,2171,2171,"3,3%",1198,237202
2021/07/25,2021-06-25,,18762,1895905,14188,59621,318,23005,193,19962,5,752,2291,2291,"3,3%",812,238014
2021/07/26,2021-06-26,,17956,1913861,"14813,857",59778,342,23347,195,20157,7,759,2431,2431,"3,3%",1114,239128
2021/07/27,2021-06-27,,15036,1928897,"15082,571",59900,361,23708,147,20304,6,765,2639,2639,"3,2%",1205,240333
2021/07/28,2021-06-28,,12222,1941119,15520,60038,539,24247,58,20362,5,770,3115,3115,"3,2%",1501,241834
2021/07/29,2021-06-29,,13347,1954466,15842,60264,601,24848,114,20476,2,772,3600,3600,"3,1%",1752,243586
2021/07/30,2021-06-30,,19506,1973972,"16129,571",60647,667,25515,227,20703,7,779,4033,4033,"3,1%",1774,245360
2021/07/31,2021-07-01,,21584,1995556,"16916,143",61029,464,25979,215,20918,8,787,4274,4274,"3,0%",1076,246436
2021/08/01,2021-07-02,,24270,2019826,17703,61332,241,26220,129,21047,11,798,4375,4375,"3,0%",940,247376
2021/08/02,2021-07-03,,26485,2046311,"18921,429",61507,408,26628,266,21313,8,806,4509,4509,"3,0%",1356,248732
2021/08/03,2021-07-04,,16585,2062896,"19142,714",61840,839,27467,508,21821,7,813,4833,4833,"3,0%",2140,250872
2021/08/04,2021-07-05,,12513,2075409,"19184,286",62171,1068,28535,306,22127,5,818,5590,5590,"2,9%",2227,253099
2021/08/05,2021-07-06,,15500,2090909,"19491,857",62628,862,29397,319,22446,9,827,6124,6124,"2,8%",2809,255908
2021/08/06,2021-07-07,,21427,2112336,"19766,286",63039,980,30377,350,22796,8,835,6746,6746,"2,7%",2358,258266
2021/08/07,2021-07-08,,22910,2135246,"19955,714",63499,410,30787,297,23093,9,844,6850,6850,"2,7%",2220,260486
2021/08/08,2021-07-09,,22441,2157687,"19694,429",63873,273,31060,437,23530,17,861,6669,6669,"2,8%",1335,261821
2021/08/09,2021-07-10,,21610,2179297,18998,64138,678,31738,370,23900,13,874,6964,6964,"2,8%",1306,263127
2021/08/10,2021-07-11,,16302,2195599,"18957,571",64289,1060,32798,409,24309,15,889,7600,7600,"2,7%",2486,265613
2021/08/11,2021-07-12,,11182,2206781,"18767,429",64509,767,33565,454,24763,7,896,7906,7906,"2,7%",2706,268319
2021/08/12,2021-07-13,,12535,2219316,"18343,857",65142,1020,34585,371,25134,9,905,8546,8546,"2,6%",2886,271205
2021/08/13,2021-07-14,,17489,2236805,"17781,286",65595,765,35350,417,25551,7,912,8887,8887,"2,6%",2543,273748
2021/08/14,2021-07-15,,16435,2253240,"16856,286",65972,501,35851,455,26006,12,924,8921,8921,"2,6%",1898,275646
2021/08/15,2021-07-16,,15939,2269179,"15927,429",66385,157,36008,417,26423,10,934,8651,8651,"2,6%",1527,277173
2021/08/16,2021-07-17,,14701,2283880,"14940,429",66676,506,36514,385,26808,8,942,8764,8764,"2,6%",2036,279209
2021/08/17,2021-07-18,,11215,2295095,"14213,714",66859,747,37261,392,27200,9,951,9110,9110,"2,6%",2419,281628
2021/08/18,2021-07-19,,7209,2302304,"13646,143",67080,769,38030,570,27770,10,961,9299,9299,"2,5%",2725,284353
2021/08/19,2021-07-20,,8928,2311232,"13130,857",67676,709,38739,574,28344,12,973,9422,9422,"2,5%",3001,287354
2021/08/20,2021-07-21,,16240,2327472,"12952,429",68192,791,39530,424,28768,11,984,9778,9778,"2,5%",2639,289993
2021/08/21,2021-07-22,,14858,2342330,"12727,143",68625,753,40283,540,29308,7,991,9984,9984,"2,5%",1790,291783
2021/08/22,2021-07-23,,13719,2356049,12410,69075,172,40455,402,29710,13,1004,9741,9741,"2,5%",1522,293305
2021/08/23,2021-07-24,,12056,2368105,"12032,143",69488,259,40714,404,30114,18,1022,9578,9578,"2,5%",1744,295049
2021/08/24,2021-07-25,,9718,2377823,"11818,286",69775,515,41229,566,30680,11,1033,9516,9516,"2,5%",2146,297195
2021/08/25,2021-07-26,,5667,2383490,11598,70018,451,41680,587,31267,9,1042,9371,9371,"2,5%",2688,299883
2021/08/26,2021-07-27,,7733,2391223,"11427,286",70338,477,42157,501,31768,15,1057,9332,9332,"2,5%",1942,301825
2021/08/27,2021-07-28,,17302,2408525,11579,70908,326,42483,597,32365,6,1063,9055,9055,"2,5%",1822,303647
2021/08/28,2021-07-29,,13626,2422151,11403,71431,236,42719,575,32940,4,1067,8712,8712,"2,5%",1379,305026
2021/08/29,2021-07-30,,12885,2435036,"11283,857",71679,109,42828,609,33549,14,1081,8198,8198,"2,5%",1039,306065
2021/08/30,2021-07-31,,12418,2447454,"11335,571",72013,226,43054,576,34125,13,1094,7835,7835,"2,5%",1126,307191
2021/08/31,2021-08-01,,8730,2456184,"11194,429",72191,317,43371,653,34778,7,1101,7492,7492,"2,5%",1232,308423
2021/09/01,2021-08-02,,5574,2461758,"11181,143",72437,255,43626,763,35541,11,1112,6973,6973,"2,5%",1481,309904
2021/09/02,2021-08-03,,8988,2470746,"11360,429",72992,231,43857,607,36148,17,1129,6580,6580,"2,6%",1185,311089
2021/09/03,2021-08-04,,13263,2484009,"10783,429",73415,157,44014,734,36882,3,1132,6000,6000,"2,6%",1252,312341
2021/09/04,2021-08-05,,13646,2497655,"10786,286",73873,120,44134,779,37661,12,1144,5329,5329,"2,6%",1028,313369
2021/09/05,2021-08-06,,13523,2511178,"10877,429",74352,42,44176,535,38196,1,1145,4835,4835,"2,6%",979,314348
2021/09/06,2021-08-07,,12310,2523488,10862,74623,58,44234,675,38871,11,1156,4207,4207,"2,6%",879,315227
2021/09/07,2021-08-08,,9978,2533466,"11040,286",74813,145,44379,639,39510,2,1158,3711,3711,"2,6%",,315227
2021/09/08,2021-08-09,,6756,2540222,"11209,143",75012,121,44500,705,40215,5,1163,3122,3122,"2,6%",1235,316462
2021/09/09,2021-08-10,,6540,2546762,"10859,429",75201,146,44646,674,40889,3,1166,2591,2591,"2,6%",1128,317590
2021/09/10,2021-08-11,,7478,2554240,10033,75774,131,44777,520,41409,1,1167,2201,2201,"2,6%",1037,318627
2021/09/11,2021-08-12,,14271,2568511,"10122,286",76247,54,44831,411,41820,2,1169,1842,1842,"2,6%",904,319531
2021/09/12,2021-08-13,,13916,2582427,"10178,429",76631,32,44863,690,42510,3,1172,1181,1181,"2,6%",860,320391
2021/09/13,2021-08-14,,13020,2595447,"10279,857",76869,113,44976,119,42629,7,1179,1168,1168,"2,6%",768,321159
2021/09/14,2021-08-15,,10139,2605586,"10302,857",77141,108,45084,112,42741,7,1186,1157,1157,"2,6%",1125,322284
2021/09/15,2021-08-16,,7983,2613569,"10478,143",77440,94,45178,95,42836,4,1190,1152,1152,"2,6%",1049,323333
2021/09/16,2021-08-17,,10685,2624254,"11070,286",77993,96,45274,72,42908,4,1194,1172,1172,"2,6%",1298,324631
2021/09/17,2021-08-18,,14727,2638981,"12105,857",78377,43,45317,58,42966,0,1194,1157,1157,"2,6%",1079,325710
2021/09/18,2021-08-19,,13671,2652652,"12020,143",78694,35,45352,119,43085,0,1194,1073,1073,"2,6%",1014,326724
2021/09/19,2021-08-20,,14312,2666964,"12076,714",78983,28,45380,151,43236,1,1195,949,949,"2,6%",833,327557
2021/09/20,2021-08-21,,13261,2680225,"12111,143",79251,15,45395,137,43373,5,1200,822,822,"2,6%",896,328453
2021/09/21,2021-08-22,,10748,2690973,"12198,143",79421,107,45502,128,43501,2,1202,799,799,"2,6%",1049,329502
2021/09/22,2021-08-23,,7632,2698605,12148,79584,76,45578,54,43555,2,1204,819,819,"2,6%",1238,330740
2021/09/23,2021-08-24,,10346,2708951,"12099,571",79953,55,45633,31,43586,5,1209,838,838,"2,6%",1176,331916
2021/09/24,2021-08-25,,13251,2722202,"11888,714",80469,68,45701,111,43697,1,1210,794,794,"2,6%",1065,332981
2021/09/25,2021-08-26,,12771,2734973,"11760,143",80826,41,45742,107,43804,2,1212,726,726,"2,6%",754,333735
2021/09/26,2021-08-27,,12045,2747018,"11436,286",81187,28,45770,87,43891,0,1212,667,667,"2,6%",698,334433
2021/09/27,2021-08-28,,10173,2757191,"10995,143",81461,42,45812,92,43983,1,1213,616,616,"2,6%",879,335312
2021/09/28,2021-08-29,,7740,2764931,"10565,429",81595,58,45870,42,44025,3,1216,629,629,"2,7%",1087,336399
2021/07/29,2021-08-30,,5644,2770575,"10281,429",81830,34,45904,35,44060,1,1217,627,627,"2,7%",1223,337622
2021/09/30,2021-08-31,,7084,2777659,"9815,429",82261,20,45924,26,44086,3,1220,618,618,"2,7%",1069,338691
2021/10/01,2021-09-01,,9544,2787203,"9285,857",82496,47,45971,117,44203,3,1223,545,545,"2,7%",987,339678
2021/10/02,2021-09-02,,9202,2796405,8776,82914,34,46005,69,44272,1,1224,509,509,"2,7%",846,340524
2021/10/03,2021-09-03,,9199,2805604,"8369,429",83161,42,46047,54,44326,0,1224,497,497,"2,7%",738,341262
2021/10/04,2021-09-04,,8410,2814014,"8117,571",83343,50,46097,67,44393,0,1224,480,480,"2,7%",,341262
2021/10/05,2021-09-05,,5931,2819945,"7859,143",83419,55,46152,41,44434,2,1226,492,492,"2,7%",1098,342360
2021/10/06,2021-09-06,,4118,2824063,"7641,143",83617,41,46193,28,44462,0,1226,505,505,"2,7%",1037,343397
2021/10/07,2021-09-07,,5771,2829834,"7453,571",83899,33,46226,41,44503,0,1226,497,497,"2,7%",1109,344506
2021/10/08,2021-09-08,,6939,2836773,"7081,429",84152,29,46255,56,44559,1,1227,469,469,"2,7%",987,345493
2021/10/09,2021-09-09,,6269,2843042,"6662,429",84327,18,46273,33,44592,0,1227,454,454,"2,7%",635,346128
2021/10/10,2021-09-10,,5883,2848925,"6188,714",84608,3,46276,19,44611,0,1227,438,438,"2,7%",886,347014
2021/10/11,2021-09-11,,5309,2854234,"5745,714",84751,8,46284,47,44658,2,1229,397,397,"2,7%",967,347981
2021/10/12,2021-09-12,,3961,2858195,"5464,286",84877,29,46313,34,44692,1,1230,391,391,"2,7%",989,348970
2021/10/13,2021-09-13,,2640,2860835,"5253,143",85002,17,46330,42,44734,1,1231,365,365,"2,7%",1132,350102
2021/10/14,2021-09-14,,3699,2864534,"4957,143",85302,14,46344,50,44784,1,1232,328,328,"2,7%",1111,351213
2021/10/15,2021-09-15,,4667,2869201,"4632,571",85468,15,46359,55,44839,1,1233,287,287,"2,7%",897,352110
2021/10/16,2021-09-16,,4214,2873415,4339,85779,2,46361,35,44874,0,1233,254,254,"2,7%",865,352975
2021/10/17,2021-09-17,,3648,2877063,"4019,714",85952,2,46363,38,44912,0,1233,218,218,"2,7%",431,353406
2021/10/18,2021-09-18,,3286,2880349,"3730,714",86116,8,46371,29,44941,2,1235,195,195,"2,7%",435,353841
2021/10/19,2021-09-19,,2281,2882630,"3490,714",86174,1,46372,18,44959,1,1236,177,177,"2,7%",495,354336
2021/10/20,2021-09-20,,1504,2884134,"3328,429",86216,4,46376,11,44970,0,1236,170,170,"2,7%",425,354761
2021/10/21,2021-09-21,,2197,2886331,"3113,857",86376,4,46380,28,44998,2,1238,144,144,"2,7%",394,355155
2021/10/22,2021-09-22,,2967,2889298,2871,86500,3,46383,15,45013,1,1239,131,131,"2,7%",453,355608
2021/10/23,2021-09-23,,2783,2892081,"2666,571",86655,1,46384,14,45027,2,1241,116,116,"2,7%",487,356095
2021/10/24,2021-09-24,,2261,2894342,"2468,429",86967,0,46384,15,45042,0,1241,101,101,"2,7%",532,356627
2021/10/25,2021-09-25,,1634,2895976,"2232,429",87001,3,46387,12,45054,1,1242,91,91,"2,7%",456,357083
2021/10/26,2021-09-26,,967,2896943,"2044,714",87052,3,46390,21,45075,0,1242,73,73,"2,7%",520,357603
2021/10/27,2021-09-27,,578,2897521,"1912,429",87216,3,46393,17,45092,0,1242,59,59,"2,7%",660,358263
2021/10/28,2021-09-28,,1367,2898888,"1793,857",87417,3,46396,33,45125,0,1242,29,29,"2,7%",621,358884
2021/10/29,2021-09-29,,0,2898888,1370,87417,7,46403,0,45125,0,1242,36,36,"2,7%",724,359608
2021/10/30,2021-09-30,,3784,2902672,1513,87626,10,46413,4,45129,0,1242,42,42,"2,7%",689,360297
2021/10/31,2021-10-01,,1635,2904307,"1423,571",87705,8,46421,0,45129,0,1242,50,50,"2,7%",412,360709
2021/11/01,2021-10-02,,1306,2905613,"1376,714",87753,9,46430,7,45136,0,1242,52,52,"2,7%",600,361309
2021/11/02,2021-10-03,,809,2906422,"1354,143",87780,8,46438,1,45137,0,1242,59,59,"2,7%",715,362024
2021/11/03,2021-10-04,,429,2906851,"1332,857",87819,9,46447,0,45137,0,1242,68,68,"2,7%",678,362702
2021/11/04,2021-10-05,,768,2907619,"1247,286",87922,7,46454,3,45140,1,1243,71,71,"2,7%",800,363502
2021/11/05,2021-10-06,,1149,2908768,"1411,429",87981,1,46455,9,45149,0,1243,63,63,"2,7%",754,364256
2021/11/06,2021-10-07,,989,2909757,"1012,143",88104,2,46457,18,45167,1,1244,46,46,"2,7%",714,364970
2021/11/07,2021-10-08,,924,2910681,"910,571",88236,0,46457,15,45182,0,1244,31,31,"2,7%",513,365483
2021/11/08,2021-10-09,,816,2911497,"840,571",88292,3,46460,2,45184,0,1244,32,32,"2,7%",389,365872
2021/11/09,2021-10-10,,648,2912145,"817,571",88317,2,46462,17,45201,0,1244,17,17,"2,7%",654,366526
2021/11/10,2021-10-11,,201,2912346,785,88346,2,46464,1,45202,1,1245,17,17,"2,7%",735,367261
2021/11/11,2021-10-12,,592,2912938,"759,857",88429,1,46465,0,45202,0,1245,18,18,"2,7%",709,367970
2021/11/12,2021-10-13,,942,2913880,"730,286",88466,1,46466,1,45203,0,1245,18,18,"2,7%",687,368657
2021/11/13,2021-10-14,,947,2914827,"724,286",88506,6,46472,1,45204,0,1245,23,23,"2,7%",490,369147
2021/11/14,2021-10-15,,733,2915560,697,88562,0,46472,0,45204,0,1245,23,23,"2,7%",457,369604
2021/11/15,2021-10-16,,619,2916179,"668,857",88587,7,46479,0,45204,0,1245,30,30,"2,7%",387,369991
2021/11/16,2021-10-17,,414,2916593,"635,429",88612,2,46481,0,45204,0,1245,32,32,"2,7%",594,370585
2021/11/17,2021-10-18,,210,2916803,"636,714",88619,3,46484,3,45207,1,1246,31,31,"2,7%",609,371194
2021/11/18,2021-10-19,,452,2917255,"616,714",88674,1,46485,3,45210,2,1248,27,27,"2,7%",778,371972
2021/11/19,2021-10-20,,591,2917846,"566,571",88754,0,46485,1,45211,0,1248,26,26,"2,7%",617,372589
2021/11/20,2021-10-21,,520,2918366,"505,571",88835,1,46486,3,45214,0,1248,24,24,"2,7%",490,373079
2021/11/21,2021-10-22,,517,2918883,"474,714",88891,1,46487,4,45218,0,1248,21,21,"2,7%",510,373589
2021/11/22,2021-10-23,,449,2919332,"450,429",88914,4,46491,0,45218,0,1248,25,25,"2,7%",445,374034
2021/11/23,2021-10-24,,300,2919632,"434,143",88925,7,46498,5,45223,0,1248,27,27,"2,7%",696,374730
2021/11/24,2021-10-25,,146,2919778,425,88934,8,46506,6,45229,0,1248,29,29,"2,7%",715,375445
2021/11/25,2021-10-26,,331,2920109,"407,714",88987,8,46514,0,45229,0,1248,37,37,"2,7%",834,376279
2021/11/26,2021-10-27,,472,2920581,"390,714",89049,10,46524,9,45238,0,1248,38,38,"2,7%",856,377135
2021/11/27,2021-10-28,,533,2921114,"392,571",89104,4,46528,0,45238,0,1248,42,42,"2,7%",967,378102
2021/11/28,2021-10-29,,475,2921589,"386,571",89151,10,46538,3,45241,0,1248,49,49,"2,7%",569,378671
2021/11/29,2021-10-30,,297,2921886,"364,857",89163,44,46582,0,45241,0,1248,93,93,"2,7%",535,379206
2021/11/30,2021-10-31,,230,2922116,"354,857",89177,74,46656,1,45242,0,1248,166,166,"2,7%",800,380006
2021/12/01,2021-11-01,,106,2922222,"349,143",89179,97,46753,1,45243,0,1248,262,262,"2,7%",926,380932
2021/12/02,2021-11-02,,169,2922391,326,89197,164,46917,5,45248,0,1248,421,421,"2,7%",1012,381944
2021/12/03,2021-11-03,,344,2922735,"307,714",89220,241,47158,7,45255,0,1248,655,655,"2,6%",1054,382998
2021/12/04,2021-11-04,,319,2923054,"277,143",89251,210,47368,8,45263,0,1248,857,857,"2,6%",1437,384435
2021/12/05,2021-11-05,,339,2923393,"257,714",89295,136,47504,8,45271,0,1248,985,985,"2,6%",835,385270
2021/12/06,2021-11-06,,358,2923751,"266,429",89319,347,47851,9,45280,0,1248,1323,1323,"2,6%",931,386201
2021/12/07,2021-11-07,,205,2923956,"262,857",89332,507,48358,4,45284,0,1248,1826,1826,"2,6%",1389,387590
2021/12/08,2021-11-08,,116,2924072,"264,286",89352,895,49253,12,45296,0,1248,2709,2709,"2,5%",1653,389243
2021/12/09,2021-11-09,,245,2924317,"275,143",89387,1084,50337,41,45337,0,1248,3752,3752,"2,5%",1465,390708
2021/12/10,2021-11-10,,305,2924622,"269,571",89435,835,51172,72,45409,0,1248,4515,4515,"2,4%",1638,392346
2021/12/11,2021-11-11,,356,2924978,"274,857",89452,1002,52174,94,45503,0,1248,5423,5423,"2,4%",1030,393376
2021/12/12,2021-11-12,,393,2925371,"282,571",89469,469,52643,159,45662,2,1250,5731,5731,"2,4%",1267,394643
2021/12/13,2021-11-13,,306,2925677,"275,143",89476,866,53509,241,45903,2,1252,6354,6354,"2,3%",1556,396199
2021/12/14,2021-11-14,,262,2925939,"283,286",89484,1222,54731,210,46113,2,1254,7364,7364,"2,3%",2016,398215
2021/12/15,2021-11-15,,136,2926075,"286,143",89489,1469,56200,134,46247,0,1254,8699,8699,"2,2%",1768,399983
2021/12/16,2021-11-16,,273,2926348,"290,143",89504,1642,57842,343,46590,1,1255,9997,9997,"2,2%",1979,401962
2021/12/17,2021-11-17,,566,2926914,"327,429",89515,1034,58876,507,47097,3,1258,10521,10521,"2,1%",2146,404108
2021/12/18,2021-11-18,,585,2927499,"360,143",89555,838,59714,895,47992,2,1260,10462,10462,"2,1%",1486,405594
2021/12/19,2021-11-19,,789,2928288,"416,714",89562,322,60036,876,48868,1,1261,9907,9907,"2,1%",1095,406689
2021/12/20,2021-11-20,,887,2929175,"499,714",89572,1110,61146,1045,49913,2,1263,9970,9970,"2,1%",1234,407923
2021/12/21,2021-11-21,,687,2929862,"560,429",89574,948,62094,886,50799,2,1265,10030,10030,"2,04%",1654,409577
2021/12/22,2021-11-22,,312,2930174,"585,571",89584,796,62890,588,51387,2,1267,10236,10236,"2,01%",1762,411339
2021/12/23,2021-11-23,,,2948760,,89635,550,63440,866,52253,2,1269,9918,9918,"2,00%",1562,412901
2021/12/24,2021-11-24,,1275,2950035,"647,857",89657,513,63953,833,53086,3,1272,9595,9595,"2,0%",1038,413939
2021/12/25,2021-11-25,,2465,2952500,"916,429",89771,428,64381,750,53836,0,1272,9273,9273,"2,0%",1256,415195
2021/12/26,2021-11-26,,2828,2955328,"1207,714",89783,62,64443,1107,54943,5,1277,8223,8223,"2,0%",1013,416208
2021/12/27,2021-11-27,,3220,2958548,1541,89791,118,64561,902,55845,7,1284,7432,7432,"2,0%",734,416942
2021/12/28,2021-11-28,,2858,2961406,"1851,143",89797,312,64873,738,56583,8,1292,6998,6998,"2,0%",1021,417963
2021/12/29,2021-11-29,,2273,2963679,"2131,286",89822,600,65473,1034,57617,4,1296,6560,6560,"2,0%",1129,419092
2021/12/30,2021-11-30,,4373,2968052,2756,89843,359,65832,828,58445,3,1299,6088,6088,"2,0%",1189,420281
2021/12/31,2021-12-01,,8561,2976613,"3796,857",89871,277,66109,322,58767,4,1303,6039,6039,"2,0%",1203,421484
2022/01/01,2021-12-02,,11535,2988148,"5092,571",89915,132,66241,1110,59877,5,1308,5056,5056,"2,0%",923,422407
2022/01/02,2021-12-03,,16055,3004203,"6982,143",89944,45,66286,949,60826,2,1310,4150,4150,"2,0%",564,422971
2022/01/03,2021-12-04,,16366,3020569,"8860,143",89965,155,66441,795,61621,5,1315,3505,3505,"2,0%",870,423841
2022/01/04,2021-12-05,,11125,3031694,"10041,143",89966,233,66674,550,62171,3,1318,3185,3185,"2,0%",1021,424862
2022/01/05,2021-12-06,,6381,3038075,10628,89975,199,66873,513,62684,2,1320,2869,2869,"2,0%",1122,425984
2022/01/06,2021-12-07,,13147,3051222,"11881,429",90002,148,67021,428,63112,6,1326,2583,2583,"2,0%",954,426938
2022/01/07,2021-12-08,,19842,3071064,13493,90038,150,67171,180,63292,3,1329,2550,2550,"2,0%",1104,428042
2022/01/08,2021-12-09,,22388,3093452,"15043,429",90060,69,67240,312,63604,3,1332,2304,2304,"2,0%",835,428877
2022/01/09,2021-12-10,,19017,3112469,"15466,571",90080,54,67294,600,64204,4,1336,1754,1754,"2,0%",1278,430155
2022/01/10,2021-12-11,,17153,3129622,15579,90116,79,67373,359,64563,5,1341,1469,1469,"2,0%",921,431076
2022/01/11,2021-12-12,,37875,3167497,"19400,429",90137,119,67492,277,64840,4,1345,1307,1307,"2,0%",890,431966
2022/01/12,2021-12-13,,13288,3180785,"20387,143",90148,72,67564,177,65017,4,1349,1198,1198,"2,0%",996,432962
2022/01/13,2021-12-14,,23857,3204642,"21917,143",90172,112,67676,155,65172,3,1352,1152,1152,"2,0%",891,433853
2022/01/14,2021-12-15,,26389,3231031,"22852,429",90226,101,67777,233,65405,4,1356,1016,1016,"2,0%",1087,434940
2022/01/15,2021-12-16,,24785,3255816,"23194,857",90262,53,67830,199,65604,1,1357,869,869,"2,0%",833,435773
2022/01/16,2021-12-17,,20713,3276529,"23437,143",90297,19,67849,148,65752,6,1363,734,734,"2,0%",532,436305
2022/01/17,2021-12-18,,16080,3292609,"23283,857",90345,29,67878,147,65899,0,1363,616,616,"2,0%",698,437003
2022/01/18,2021-12-19,,15465,3308074,"20082,429",90348,57,67935,69,65968,2,1365,602,602,"2,0%",823,437826
2022/01/19,2021-12-20,,8511,3316585,19400,90453,40,67975,54,66022,0,1365,588,588,"2,0%",987,438813
2022/01/20,2021-12-21,,15423,3332008,"18195,143",90488,28,68003,78,66100,1,1366,537,537,"2,0%",969,439782
2022/01/21,2021-12-22,,21098,3353106,"17439,286",90587,44,68047,117,66217,0,1366,464,464,"2,0%",921,440703
2022/01/22,2021-12-23,,21156,3374262,"16920,857",90662,14,68061,72,66289,1,1367,405,405,"2,0%",765,441468
2022/01/23,2021-12-24,,18847,3393109,"16654,286",90743,20,68081,108,66397,2,1369,315,315,"2,0%",657,442125
2022/01/24,2021-12-25,,14828,3407937,"16475,429",90773,37,68118,99,66496,1,1370,252,252,"2,0%",638,442763
2022/01/25,2021-12-26,,5603,3413540,"15066,571",90814,46,68164,52,66548,0,1370,246,246,"2,0%",887,443650
2022/01/26,2021-12-27,,3778,3417318,"14390,429",90829,41,68205,19,66567,1,1371,267,267,"2,0%",943,444593
2022/01/27,2021-12-28,,7216,3424534,13218,90854,34,68239,29,66596,2,1373,270,270,"2,0%",879,445472
2022/01/28,2021-12-29,,9020,3433554,"11492,571",90935,62,68301,57,66653,0,1373,275,275,"2,0%",903,446375
2022/01/29,2021-12-30,,12978,3446532,"10324,286",91061,28,68329,40,66693,1,1374,262,262,"2,0%",834,447209
2022/01/30,2021-12-31,,11754,3458286,9311,91145,13,68342,28,66721,1,1375,246,246,"2,0%",554,447763
2022/01/31,2022-01-01,,9793,3468079,"8591,714",91198,25,68367,44,66765,0,1375,227,227,"2,0%",569,448332
2022/02/01,2022-01-02,,4357,3472436,"8413,714",91228,56,68423,14,66779,0,1375,269,269,"2,0%",859,449191
2022/02/02,2022-01-03,,3076,3475512,"8313,429",91312,31,68454,20,66799,1,1376,279,279,"2,0%",945,450136
2022/02/03,2022-01-04,,8078,3483590,"8436,571",91451,51,68505,37,66836,0,1376,293,293,"2,0%",866,451002
2022/02/04,2022-01-05,,11106,3494696,"8734,571",91561,35,68540,46,66882,1,1377,281,281,"2,0%",982,451984
2022/02/05,2022-01-06,,9858,3504554,"8288,857",92112,11,68551,41,66923,0,1377,251,251,"2,0%",788,452772
2022/02/06,2022-01-07,,9259,3513813,"7932,429",92252,2,68553,34,66957,1,1378,218,218,"2,0%",532,453304
2022/02/07,2022-01-08,,7759,3521572,"7641,857",92371,26,68579,62,67019,0,1378,182,182,"2,0%",512,453816
2022/02/08,2022-01-09,,4482,3526054,"7659,714",92453,82,68661,28,67047,2,1380,234,234,"2,0%",870,454686
2022/02/09,2022-01-10,,2409,3528463,"7564,429",92530,41,68702,13,67060,1,1381,261,261,"2,0%",943,455629
2022/02/10,2022-01-11,,5668,3534131,"7220,143",92649,25,68727,25,67085,0,1381,261,261,"2,0%",896,456525
2022/02/11,2022-01-12,,6760,3540891,"6599,286",92830,35,68762,56,67141,1,1382,239,239,"2,0%",921,457446
2022/02/12,2022-01-13,,5917,3546808,"6036,286",92989,19,68781,31,67172,1,1383,226,226,"2,0%",632,458078
2022/02/13,2022-01-14,,5235,3552043,"5461,429",93117,14,68795,51,67223,0,1383,189,189,"2,0%",598,458676
2022/02/14,2022-01-15,,4590,3556633,"5008,714",93278,20,68815,35,67258,1,1384,173,173,"2,0%",481,459157
2022/02/15,2022-01-16,,2659,3559292,"4748,286",93364,43,68858,11,67269,0,1384,205,205,"2,0%",632,459789
2022/02/16,2022-01-17,,1629,3560921,"4636,857",93451,42,68900,2,67271,2,1386,243,243,"2,0%",863,460652
2022/02/17,2022-01-18,,3657,3564578,"4349,571",93571,25,68925,26,67297,0,1386,242,242,"2,0%",936,461588
2022/02/18,2022-01-19,,0,3564578,"3383,857",93571,32,68957,82,67379,0,1386,192,192,"2,0%",822,462410
2022/02/19,2022-01-20,,8282,3572860,"3721,714",93846,15,68972,41,67420,2,1388,164,164,"2,0%",683,463093
2022/02/20,2022-01-21,,3519,3576379,"3476,571",93949,6,68978,28,67448,0,1388,142,142,"2,0%",525,463618
2022/02/21,2022-01-22,,3049,3579428,"3256,429",94063,15,68993,35,67483,1,1389,121,121,"2,0%",462,464080
2022/02/22,2022-01-23,,1931,3581359,"3152,429",94177,28,69021,19,67502,1,1390,129,129,"2,0%",798,464878
2022/02/23,2022-01-24,,1332,3582691,3110,94625,29,69050,11,67513,0,1390,147,147,"2,0%",923,465801
2022/02/24,2022-01-25,,3197,3585888,"3044,286",94397,45,69095,20,67533,0,1390,172,172,"2,0%",961,466762
2022/02/25,2022-01-26,,4511,3590399,"3688,714",94491,24,69119,43,67576,0,1390,153,153,"2,0%",873,467635
2022/02/26,2022-01-27,,4100,3594499,"3091,286",94651,6,69125,42,67618,0,1390,117,117,"2,0%",643,468278
2022/02/27,2022-01-28,,3789,3598288,"3129,857",94784,5,69130,25,67643,0,1390,97,97,"2,0%",555,468833
2022/02/28,2022-01-29,,3342,3601630,"3171,714",94905,30,69160,32,67675,0,1390,95,95,"2,0%",446,469279
2022/03/01,2022-01-30,,2226,3603856,"3213,857",95022,31,69191,15,67690,0,1390,111,111,"2,0%",689,469968
2022/03/02,2022-01-31,,1366,3605222,"3218,714",95093,20,69211,6,67696,0,1390,125,125,"2,0%",887,470855
2022/03/03,2022-02-01,,3085,3608307,"3202,714",95288,47,69258,15,67711,1,1391,156,156,"2,0%",843,471698
2022/03/04,2022-02-02,,4502,3612809,"3201,429",95463,32,69290,28,67739,0,1391,160,160,"2,0%",899,472597
2022/03/05,2022-02-03,,3266,3616075,"3082,286",95545,7,69297,29,67768,0,1391,138,138,"2,0%",723,473320
2022/03/06,2022-02-04,,0,3616075,2541,95545,1,69298,43,67811,0,1391,96,96,"2,0%",465,473785
2022/03/07,2022-02-05,,6135,3622210,2940,95817,9,69307,24,67835,0,1391,81,81,"2,0%",368,474153
2022/03/08,2022-02-06,,1752,3623962,"2872,286",95835,24,69331,6,67841,0,1391,99,99,"2,0%",569,474722
2022/03/09,2022-02-07,,1228,3625190,"2852,571",96021,20,69351,5,67846,0,1391,114,114,"2,0%",623,475345
2022/03/10,2022-02-08,,824,3626014,"2529,571",96289,28,69379,30,67876,1,1392,111,111,"2,0%",867,476212
2022/03/11,2022-02-09,,5628,3631642,"2690,429",96502,29,69408,56,67932,0,1392,84,84,"2,0%",888,477100
2022/03/12,2022-02-10,,3169,3634811,"2676,571",96705,21,69429,31,67963,0,1392,74,74,"2,0%",549,477649
2022/03/13,2022-02-11,,2862,3637673,"3085,429",96851,6,69435,47,68010,0,1392,33,33,"2,0%",423,478072
2022/03/14,2022-02-12,,2489,3640162,"2564,571",96985,24,69459,32,68042,0,1392,25,25,"2,0%",418,478490
2022/03/15,2022-02-13,,1649,3641811,"2549,857",96993,19,69478,7,68049,0,1392,37,37,"2,0%",589,479079
2022/03/16,2022-02-14,,1094,3642905,"2530,714",97250,29,69507,2,68051,0,1392,64,64,"2,0%",734,479813
2022/03/17,2022-02-15,,2364,3645269,"2750,714",97431,20,69527,26,68077,0,1392,58,58,"2,0%",823,480636
2022/03/18,2022-02-16,,3699,3648968,"2475,143",97520,14,69541,6,68083,0,1392,66,66,"2,0%",919,481555
2022/03/19,2022-02-17,,3056,3652024,2459,97955,7,69548,20,68103,0,1392,53,53,"2,0%",734,482289
2022/03/20,2022-02-18,,2800,3654824,"2450,143",98298,4,69552,28,68131,0,1392,29,29,"2,0%",3906,486195
2022/03/21,2022-02-19,,2267,3657091,"2418,429",98617,11,69563,29,68160,0,1392,11,11,"2,0%",900,487095
2022/03/22,2022-02-20,,1456,3658547,"2390,857",98667,34,69597,21,68181,0,1392,24,24,"2,0%",712,487807
2022/03/23,2022-02-21,,1151,3659698,2399,98804,13,69610,6,68187,1,1393,30,30,"2,0%",756,488563
2022/03/24,2022-02-22,,2334,3662032,"2394,714",98868,23,69633,12,68199,0,1393,41,41,"2,0%",804,489367
2022/03/25,2022-02-23,,3117,3665149,"2311,571",98978,25,69658,10,68209,0,1393,56,56,"2,0%",789,490156
2022/03/26,2022-02-24,,2411,3667560,"2219,429",99018,5,69663,14,68223,0,1393,47,47,"2,0%",792,490948
2022/03/27,2022-02-25,,2111,3669671,2121,99145,1,69664,20,68243,0,1393,28,28,"2,0%",437,491385
2022/03/28,2022-02-26,,2320,3671991,"2128,571",99191,8,69672,14,68257,1,1394,21,21,"2,0%",522,491907
2022/03/29,2022-02-27,,1266,3673257,"2101,429",99229,23,69695,7,68264,0,1394,37,37,"2,0%",732,492639
2022/03/30,2022-02-28,,785,3674042,"2049,143",99412,28,69723,4,68268,0,1394,61,61,"2,0%",534,493173
2022/03/31,2022-03-01,,1649,3675691,"1951,286",99430,48,69771,11,68279,0,1394,98,98,"2,0%",513,493686
2022/04/01,2022-03-02,,1995,3677686,1791,99458,61,69832,34,68313,0,1394,125,125,"2,0%",479,494165
2022/04/02,2022-03-03,,1853,3679539,"1711,286",99499,6,69838,13,68326,0,1394,118,118,"2,0%",723,494888
2022/04/03,2022-03-04,,1898,3681437,"1680,857",99517,13,69851,23,68349,0,1394,108,108,"2,0%",493,495381
2022/04/04,2022-03-05,,1735,3683172,"1597,286",99543,11,69862,25,68374,0,1394,94,94,"2,0%",1439,496820
2022/04/05,2022-03-06,,1147,3684319,"1580,286",99543,35,69897,5,68379,1,1395,123,123,"2,0%",567,497387
2022/04/06,2022-03-07,,801,3685120,"1582,571",99609,30,69927,1,68380,0,1395,152,152,"2,0%",583,497970
2022/04/07,2022-03-08,,1436,3686556,"1552,143",99625,20,69947,8,68388,0,1395,164,164,"2,0%",393,498363
2022/04/08,2022-03-09,,1867,3688423,"1533,857",99656,12,69959,23,68411,0,1395,153,153,"2,0%",531,498894
2022/04/09,2022-03-10,,1868,3690291,1536,99681,7,69966,28,68439,0,1395,132,132,"2,0%",437,499331
2022/04/10,2022-03-11,,1671,3691962,"1503,571",99709,2,69968,48,68487,0,1395,86,86,"2,0%",298,499629
2022/04/11,2022-03-12,,1570,3693532,1480,99712,22,69990,61,68548,0,1395,47,47,"2,0%",456,500085
2022/04/12,2022-03-13,,972,3694504,1455,99725,24,70014,6,68554,0,1395,65,65,"2,0%",343,500428
2022/04/13,2022-03-14,,671,3695175,"1436,429",99725,34,70048,13,68567,0,1395,86,86,"2,0%",321,500749
,2022-03-15,,1648,3696823,"1466,714",99727,,,,,,,,,,,
,2022-03-16,,1980,3698803,"1482,857",99767,,,,,,,,,,,
,2022-03-17,,1681,3700484,"1456,143",99829,,,,,,,,,,,
,2022-03-18,,1558,3702042,1440,99868,,,,,,,,,,,
,2022-03-19,,1287,3703329,"1399,571",99879,,,,,,,,,,,
,2022-03-20,,889,3704218,"1387,714",99881,,,,,,,,,,,
,2022-03-21,,566,3704784,"1372,714",99890,,,,,,,,,,,
,2022-03-22,,912,3705696,"1267,571",99893,,,,,,,,,,,
,2022-03-23,,1393,3707089,"1183,714",99899,,,,,,,,,,,
,2022-03-24,,2120,3709209,"1246,429",99932,,,,,,,,,,,
,2022-03-25,,1557,3710766,"1246,286",99939,,,,,,,,,,,
,2022-03-26,,1497,3712263,"1276,286",99965,,,,,,,,,,,
,2022-03-27,,989,3713252,"1290,571",99966,,,,,,,,,,,
,2022-03-28,,581,3713833,"1292,714",99970,,,,,,,,,,,
,2022-03-29,,1557,3715390,"1384,857",99976,,,,,,,,,,,
,2022-03-30,,1677,3717067,"1425,429",100020,,,,,,,,,,,
,2022-03-31,,1886,3718953,1392,100032,,,,,,,,,,,
,2022-04-01,,0,3718953,"1169,571",100032,,,,,,,,,,,
,2022-04-02,,0,3718953,"955,714",100032,,,,,,,,,,,
,2022-04-03,,4001,3722954,1386,100050,,,,,,,,,,,
,2022-04-04,,0,3722954,1303,100050,,,,,,,,,,,
,2022-04-05,,2223,3725177,"1398,143",100067,,,,,,,,,,,
,2022-04-06,,2031,3727208,"1448,714",100070,,,,,,,,,,,
,2022-04-07,,1481,3728689,"1390,857",100075,,,,,,,,,,,
,2022-04-08,,1377,3730066,"1587,571",100084,,,,,,,,,,,
,2022-04-09,,1181,3731247,"1756,286",100096,,,,,,,,,,,
,2022-04-10,,828,3732075,1303,100096,,,,,,,,,,,
,2022-04-11,,553,3732628,1382,100098,,,,,,,,,,,
